IEBCWd_No,Ward,Const_CODE,Constituen,County_COD,County,Male,Female,Total_POP,Region
1,PORT REITZ,1,CHANGAMWE,1,MOMBASA,17661,16118,33779,COAST
2,KIPEVU,1,CHANGAMWE,1,MOMBASA,15078,13050,28128,COAST
3,AIRPORT,1,CHANGAMWE,1,MOMBASA,15796,13866,29662,COAST
4,CHANGAMWE,1,CHANGAMWE,1,MOMBASA,5584,5429,11013,COAST
5,CHAANI,1,CHANGAMWE,1,MOMBASA,16190,13920,30110,COAST
6,JOMVU KUU,2,JOMVU,1,MOMBASA,19973,18803,38776,COAST
7,MIRITINI,2,JOMVU,1,MOMBASA,13643,12291,25934,COAST
8,MIKINDANI,2,JOMVU,1,MOMBASA,27305,25472,52777,COAST
9,MJAMBERE,3,KISAUNI,1,MOMBASA,14105,13180,27285,COAST
10,JUNDA,3,KISAUNI,1,MOMBASA,20949,18483,39432,COAST
11,BAMBURI,3,KISAUNI,1,MOMBASA,13373,11545,24918,COAST
12,MWAKIRUNGE,3,KISAUNI,1,MOMBASA,4322,4607,8929,COAST
13,MTOPANGA,3,KISAUNI,1,MOMBASA,13398,13205,26603,COAST
14,MAGOGONI,3,KISAUNI,1,MOMBASA,14509,14321,28830,COAST
15,SHANZU,3,KISAUNI,1,MOMBASA,19410,18657,38067,COAST
16,FRERE TOWN,4,NYALI,1,MOMBASA,20750,20928,41678,COAST
17,ZIWA LA NG'OMBE,4,NYALI,1,MOMBASA,22618,19569,42187,COAST
18,MKOMANI,4,NYALI,1,MOMBASA,15905,14671,30576,COAST
19,KONGOWEA,4,NYALI,1,MOMBASA,18635,14782,33417,COAST
20,KADZANDANI,4,NYALI,1,MOMBASA,18930,19203,38133,COAST
21,MTONGWE,5,LIKONI,1,MOMBASA,15105,13063,28168,COAST
22,SHIKA ADABU,5,LIKONI,1,MOMBASA,13141,12895,26036,COAST
23,BOFU,5,LIKONI,1,MOMBASA,15740,13414,29154,COAST
24,LIKONI,5,LIKONI,1,MOMBASA,11445,10194,21639,COAST
25,TIBWANI,5,LIKONI,1,MOMBASA,32223,28788,61011,COAST
26,MJI WA KALE/MAKADARA,6,MVITA,1,MOMBASA,12390,13485,25875,COAST
27,TUDOR,6,MVITA,1,MOMBASA,16759,15341,32100,COAST
28,TONONOKA,6,MVITA,1,MOMBASA,13630,13883,27513,COAST
29,SHIMANZI/GANJONI,6,MVITA,1,MOMBASA,9598,9208,18806,COAST
30,MAJENGO,6,MVITA,1,MOMBASA,18759,20075,38834,COAST
31,GOMBATO BOGWE,7,MSABWENI,2,KWALE,17607,17239,34846,COAST
32,UKUNDA,7,MSAMBWENI,2,KWALE,19897,18732,38629,COAST
33,KINONDO,7,MSAMBWENI,2,KWALE,11938,10919,22857,COAST
34,RAMISI,7,MSAMBWENI,2,KWALE,19129,19578,38707,COAST
35,PONGWE/KIKONENI,8,LUNGA LUNGA,2,KWALE,20069,21029,41098,COAST
36,DZOMBO,8,LUNGA LUNGA,2,KWALE,19489,22020,41509,COAST
37,MWERENI,8,LUNGA LUNGA,2,KWALE,16556,18072,34628,COAST
38,VANGA,8,LUNGA LUNGA,2,KWALE,17621,18498,36119,COAST
39,TSIMBA GOLINI,9,MATUGA,2,KWALE,16451,17551,34002,COAST
40,WAA,9,MATUGA,2,KWALE,18858,18925,37783,COAST
41,TIWI,9,MATUGA,2,KWALE,9607,9802,19409,COAST
42,KUBO SOUTH,9,MATUGA,2,KWALE,11747,11719,23466,COAST
43,MKONGANI,9,MATUGA,2,KWALE,17657,19661,37318,COAST
44,NDAVAYA,10,KINANGO,2,KWALE,13288,14528,27816,COAST
45,PUMA,10,KINANGO,2,KWALE,9555,10305,19860,COAST
46,KINANGO,10,KINANGO,2,KWALE,15471,17100,32571,COAST
47,MACKINON ROAD,10,KINANGO,2,KWALE,14993,16135,31128,COAST
48,CHENGONI/SAMBURU,10,KINANGO,2,KWALE,15127,17514,32641,COAST
49,MWABILA,10,KINANGO,2,KWALE,15092,16810,31902,COAST
50,KASEMENI,10,KINANGO,2,KWALE,15842,17800,33642,COAST
51,TEZO,11,KILIFI NORTH,3,KILIFI,12563,12982,25545,COAST
52,SOKONI,11,KILIFI NORTH,3,KILIFI,17014,18013,35027,COAST
53,KIBARANI,11,KILIFI NORTH,3,KILIFI,11952,12540,24492,COAST
54,DABASO,11,KILIFI NORTH,3,KILIFI,14670,14933,29603,COAST
55,MATSANGONI,11,KILIFI NORTH,3,KILIFI,16406,17157,33563,COAST
56,WATAMU,11,KILIFI NORTH,3,KILIFI,13156,12826,25982,COAST
57,MNARANI,11,KILIFI NORTH,3,KILIFI,16352,17023,33375,COAST
58,JUNJU,12,KILIFI SOUTH,3,KILIFI,15592,16160,31752,COAST
59,MWARAKAYA,12,KILIFI SOUTH,3,KILIFI,11545,13527,25072,COAST
60,SHIMO LA TEWA,12,KILIFI SOUTH,3,KILIFI,25243,25603,50846,COAST
61,CHASIMBA,12,KILFI SOUTH,3,KILIFI,13710,15584,29294,COAST
62,MTEPENI,12,KILIFI SOUTH,3,KILIFI,17364,17279,34643,COAST
63,MARIAKANI,13,KALOLENI,3,KILIFI,21497,21702,43199,COAST
64,KAYAFUNGO,13,KALOLENI,3,KILIFI,16055,18985,35040,COAST
65,KALOLENI,13,KALOLENI,3,KILIFI,26589,29437,56026,COAST
66,MWANAMWINGA,13,KALOLENI,3,KILIFI,9808,11666,21474,COAST
67,MWAWESA,14,RABAI,3,KILIFI,6907,8114,15021,COAST
68,RURUMA,14,RABAI,3,KILIFI,10180,11529,21709,COAST
69,KAMBE/RIBE,14,RABAI,3,KILIFI,8536,8775,17311,COAST
70,RABAI/KISURUTINI,14,RABAI,3,KILIFI,20787,22357,43144,COAST
71,GANZE,15,GANZE,3,KILIFI,14200,17133,31333,COAST
72,BAMBA,15,GANZE,3,KILIFI,17205,20625,37830,COAST
73,JARIBUNI,15,GANZE,3,KILIFI,11592,13366,24958,COAST
74,SOKOKE,15,GANZE,3,KILIFI,20052,23491,43543,COAST
75,JILORE,16,MALINDI,3,KILIFI,8239,9258,17497,COAST
76,KAKUYUNI,16,MALINDI,3,KILIFI,8607,9358,17965,COAST
77,GANDA,16,MALINDI,3,KILIFI,16184,16378,32562,COAST
78,MALINDI TOWN,16,MALINDI,3,KILIFI,25574,25680,51254,COAST
79,SHELLA,16,MALINDI,3,KILIFI,21478,21956,43434,COAST
80,MARAFA,17,MAGARINI,3,KILIFI,8177,8670,16847,COAST
81,MAGARINI,17,MAGARINI,3,KILIFI,19654,21040,40694,COAST
82,GONGONI,17,MAGARINI,3,KILIFI,16974,17623,34597,COAST
83,ADU,17,MAGARINI,3,KILIFI,20931,22074,43005,COAST
84,GARASHI,17,MAGARINI,3,KILIFI,12238,13543,25781,COAST
85,SABAKI,17,MAGARINI,3,KILIFI,8500,7817,16317,COAST
86,KIPINI EAST,18,GARSEN,4,TANA RIVER,9913,9664,19577,COAST
87,GARSEN SOUTH,18,GARSEN,4,TANA RIVER,8029,7990,16019,COAST
88,KIPINI WEST,18,GARSEN,4,TANA RIVER,9383,8616,17999,COAST
89,GARSEN CENTRAL,18,GARSEN,4,TANA RIVER,7543,7309,14852,COAST
90,GARSEN WEST,18,GARSEN,4,TANA RIVER,5208,5508,10716,COAST
91,GARSEN NORTH,18,GARSEN,4,TANA RIVER,8625,8876,17501,COAST
92,KINAKOMBA,19,GALOLE,4,TANA RIVER,6602,7034,13636,COAST
93,MIKINDUNI,19,GALOLE,4,TANA RIVER,4711,4857,9568,COAST
94,CHEWANI,19,GALOLE,4,TANA RIVER,11692,12509,24201,COAST
95,WAYU,19,GALOLE,4,TANA RIVER,6464,6997,13461,COAST
96,CHEWELE,20,BURA,4,TANA RIVER,8068,8335,16403,COAST
97,HIRIMANI,20,BURA,4,TANA RIVER,7742,7641,15383,COAST
98,BANGALE,20,BURA,4,TANA RIVER,7180,6925,14105,COAST
99,SALA,20,BURA,4,TANA RIVER,5438,4932,10370,COAST
100,MADOGO,20,BURA,4,TANA RIVER,13259,13025,26284,COAST
101,FAZA,21,LAMU EAST,5,LAMU,6762,6762,13524,COAST
102,KIUNGA,21,LAMU EAST,5,LAMU,2310,1955,4265,COAST
103,BASUBA,21,LAMU EAST,5,LAMU,542,510,1052,COAST
104,SHELLA,22,LAMU WEST,5,LAMU,1882,1392,3274,COAST
105,MKOMAMI,22,LAMU WEST,5,LAMU,9660,9432,19092,COAST
106,HINDI,22,LAMU WEST,5,LAMU,6021,4679,10700,COAST
107,MKUNUMBI,22,LAMU WEST,5,LAMU,6232,5492,11724,COAST
108,HONGWE,22,LAMU WEST,5,LAMU,4748,4349,9097,COAST
109,WITU,22,LAMU WEST,5,LAMU,6740,6365,13105,COAST
110,BAHARI,22,LAMU WEST,5,LAMU,8148,7558,15706,COAST
111,CHALA,23,TAVETA,6,TAITA TAVETA,9431,8634,18065,COAST
112,MAHOO,23,TAVETA,6,TAITA TAVETA,4105,4194,8299,COAST
113,BOMANI,23,TAVETA,6,TAITA TAVETA,5867,5515,11382,COAST
114,MBOGHONI,23,TAVETA,6,TAITA TAVETA,10736,9912,20648,COAST
115,MATA,23,TAVETA,6,TAITA TAVETA,4880,4391,9271,COAST
116,WUNDANYI/MBALE,24,WUNDANYI,6,TAITA TAVETA,9887,9781,19668,COAST
117,WERUGHA,24,WUNDANYI,6,TAITA TAVETA,4395,4281,8676,COAST
118,WUMIGU/KISHUSHE,24,WUNDANYI,6,TAITA TAVETA,9247,7687,16934,COAST
119,MWANDA/MGANGE,24,WUNDANYI,6,TAITA TAVETA,6490,6832,13322,COAST
120,RONGE,25,MWATATE,6,TAITA TAVETA,5424,5381,10805,COAST
121,MWATATE,25,MWATATE,6,TAITA TAVETA,7444,7064,14508,COAST
122,BURA,25,MWATATE,6,TAITA TAVETA,8239,8646,16885,COAST
123,CHAWIA,25,MWATATE,6,TAITA TAVETA,7314,6841,14155,COAST
124,WUSI/KISHAMBA,25,MWATATE,6,TAITA TAVETA,6491,6791,13282,COAST
125,MBOLOLO,26,VOI,6,TAITA TAVETA,12990,13001,25991,COAST
126,SAGALA,26,VOI,6,TAITA TAVETA,6255,5775,12030,COAST
127,KALOLENI,26,VOI,6,TAITA TAVETA,10998,9420,20418,COAST
128,MAUNGU,26,VOI,6,TAITA TAVETA,4403,4354,8757,COAST
129,KASIGAU,26,VOI,6,TAITA TAVETA,6784,6902,13686,COAST
130,NGOLIA,26,VOI,6,TAITA TAVETA,3953,3922,7875,COAST
131,TOWNSHIP,27,GARISSA TOWNSHIP,7,GARISSA,10343,10274,20617,NORTH EASTERN
132,GALBET,27,GARISSA TOWNSHIP,7,GARISSA,22371,20873,43244,NORTH EASTERN
133,TOWNSHIP,27,GARISSA TOWNSHIP,7,GARISSA,11596,10753,22349,NORTH EASTERN
134,TOWNSHIP,27,GARISSA TOWNSHIP,7,GARISSA,16160,14583,30743,NORTH EASTERN
135,BALAMBALA,28,BALAMBALA,7,GARISSA,11497,8832,20329,NORTH EASTERN
136,DANYERE,28,BALAMBALA,7,GARISSA,14057,10763,24820,NORTH EASTERN
137,JARAJARA,28,BALAMBALA,7,GARISSA,4028,3328,7356,NORTH EASTERN
138,SAKA,28,BALAMBALA,7,GARISSA,5359,4526,9885,NORTH EASTERN
139,SANKURI,28,BALAMBALA,7,GARISSA,5796,4923,10719,NORTH EASTERN
140,MODOGASHE,29,LAGDERA,7,GARISSA,15752,13125,28877,NORTH EASTERN
141,BENANE,29,LAGDERA,7,GARISSA,7276,5857,13133,NORTH EASTERN
142,GOREALE,29,LAGDERA,7,GARISSA,6089,4143,10232,NORTH EASTERN
143,MAALAMIN,29,LAGDERA,7,GARISSA,6045,4732,10777,NORTH EASTERN
144,SABENA,29,LAGDERA,7,GARISSA,11202,8637,19839,NORTH EASTERN
145,BARAKI,29,LAGDERA,7,GARISSA,5411,4367,9778,NORTH EASTERN
146,DERTU,30,DADAAB,7,GARISSA,8344,6669,15013,NORTH EASTERN
147,DADAAB,30,DADAAB,7,GARISSA,31725,28665,60390,NORTH EASTERN
148,LABISIGALE,30,DADAAB,7,GARISSA,23134,20607,43741,NORTH EASTERN
149,DAMAJALE,30,DADAAB,7,GARISSA,5094,4375,9469,NORTH EASTERN
150,LIBOI,30,DADAAB,7,GARISSA,6037,5403,11440,NORTH EASTERN
151,ABAKAILE,30,DADAAB,7,GARISSA,7051,5383,12434,NORTH EASTERN
152,BURA,31,FAFI,7,GARISSA,2748,2568,5316,NORTH EASTERN
153,DEKAHARIA,31,FAFI,7,GARISSA,5238,4284,9522,NORTH EASTERN
154,JARAJILA,31,FAFI,7,GARISSA,35725,32212,67937,NORTH EASTERN
155,FAFI,31,FAFI,7,GARISSA,2707,2401,5108,NORTH EASTERN
156,NANIGHI,31,FAFI,7,GARISSA,3992,3337,7329,NORTH EASTERN
157,HULUGHO,32,IJARA,7,GARISSA,11231,9722,20953,NORTH EASTERN
158,SANGAILU,32,IJARA,7,GARISSA,13242,10038,23280,NORTH EASTERN
159,IJARA,32,IJARA,7,GARISSA,8671,7384,16055,NORTH EASTERN
160,MASALANI,32,IJARA,7,GARISSA,17020,15355,32375,NORTH EASTERN
161,GURAR,33,WAJIR NORTH,8,WAJIR,10763,9671,20434,NORTH EASTERN
162,BUTE,33,WAJIR NORTH,8,WAJIR,15039,11698,26737,NORTH EASTERN
163,KORONDILE,33,WAJIR NORTH,8,WAJIR,11323,9644,20967,NORTH EASTERN
164,MALKAGUFU,33,WAJIR NORTH,8,WAJIR,3171,2715,5886,NORTH EASTERN
165,BATALU,33,WAJIR NORTH,8,WAJIR,9366,7968,17334,NORTH EASTERN
166,DANABA,33,WAJIR NORTH,8,WAJIR,16319,14116,30435,NORTH EASTERN
167,GODOMA,33,WAJIR NORTH,8,WAJIR,7652,6060,13712,NORTH EASTERN
168,WAGBERI,34,WAJIR EAST,8,WAJIR,12480,10901,23381,NORTH EASTERN
169,TOWNSHIP,34,WAJIR EAST,8,WAJIR,15476,13873,29349,NORTH EASTERN
170,BARWAQO,34,WAJIR EAST,8,WAJIR,15726,14344,30070,NORTH EASTERN
171,KHOROF/HARAR,34,WAJIR EAST,8,WAJIR,16300,13472,29772,NORTH EASTERN
172,ELBEN,35,TARBAJ,8,WAJIR,14929,12085,27014,NORTH EASTERN
173,SARMAN,35,TARBAJ,8,WAJIR,14611,11453,26064,NORTH EASTERN
174,TARBAJ,35,TARBAJ,8,WAJIR,16119,12700,28819,NORTH EASTERN
175,WARGADUD,35,TARBAJ,8,WAJIR,16444,13505,29949,NORTH EASTERN
176,ARBAJAHAN,36,WAJIR WEST,8,WAJIR,12349,9401,21750,NORTH EASTERN
177,HADADO/ATHIBOHOL,36,WAJIR WEST,8,WAJIR,10882,8382,19264,NORTH EASTERN
178,ADEMASAJIDE,36,WAJIR WEST,8,WAJIR,14561,11655,26216,NORTH EASTERN
179,GANYURE,36,WAJIR WEST,8,WAJIR,8072,6770,14842,NORTH EASTERN
180,WAGALLA,36,WAJIR WEST,8,WAJIR,4848,4223,9071,NORTH EASTERN
181,ELDAS,37,ELDAS,8,WAJIR,10923,8399,19322,NORTH EASTERN
182,DELLA,37,ELDAS,8,WAJIR,12511,8569,21080,NORTH EASTERN
183,ELNUR/TULA TULA,37,ELDAS,8,WAJIR,22476,17927,40403,NORTH EASTERN
184,BENANE,38,WAJIR SOUTH,8,WAJIR,13236,11306,24542,NORTH EASTERN
185,BUR-DER,38,WAJIR SOUTH,8,WAJIR,5696,4922,10618,NORTH EASTERN
186,DADAJA BULLA,38,WAJIR SOUTH,8,WAJIR,4823,3870,8693,NORTH EASTERN
187,HABASWEIN,38,WAJIR SOUTH,8,WAJIR,14998,12970,27968,NORTH EASTERN
188,LAGBOGHOL SOUTH,38,WAJIR SOUTH,8,WAJIR,12506,10125,22631,NORTH EASTERN
189,IBRAHIM URE,38,WAJIR SOUTH,8,WAJIR,11120,8806,19926,NORTH EASTERN
190,DIFF,38,WAJIR SOUTH,8,WAJIR,9056,6636,15692,NORTH EASTERN
191,TAKABA SOUTH,39,MANDERA WEST,9,MANDERA,22818,19739,42557,NORTH EASTERN
192,TAKABA,39,MANDERA WEST,9,MANDERA,18265,15277,33542,NORTH EASTERN
193,LAGHSURE,39,MANDERA WEST,9,MANDERA,7735,7102,14837,NORTH EASTERN
194,DANDU,39,MANDERA WEST,9,MANDERA,20769,16725,37494,NORTH EASTERN
195,GITHER,39,MANDERA WEST,9,MANDERA,17660,15611,33271,NORTH EASTERN
196,BANISSA,40,BANISSA,9,MANDERA,23908,20593,44501,NORTH EASTERN
197,DERKHALE,40,BANISSA,9,MANDERA,17780,14298,32078,NORTH EASTERN
198,GUBA,40,BANISSA,9,MANDERA,11472,8596,20068,NORTH EASTERN
199,MALKAMARI,40,BANISSA,9,MANDERA,15801,11801,27602,NORTH EASTERN
200,KILIWAHERI,40,BANISSA,9,MANDERA,18604,15221,33825,NORTH EASTERN
201,ASHABITO,41,MANDERA NORTH,9,MANDERA,23987,19462,43449,NORTH EASTERN
202,GUTICHA,41,MANDERA NORTH,9,MANDERA,18978,14680,33658,NORTH EASTERN
203,MAROTHILE,41,MANDERA NORTH,9,MANDERA,7650,5900,13550,NORTH EASTERN
204,RHAMU,41,MANDERA NORTH,9,MANDERA,24401,18021,42422,NORTH EASTERN
205,RHAMU DIMTU,41,MANDERA NORTH,9,MANDERA,19953,16643,36596,NORTH EASTERN
206,WARGADUD,42,MANDERA SOUTH,9,MANDERA,16461,13938,30399,NORTH EASTERN
207,KOTULO,42,MANDERA SOUTH,9,MANDERA,36254,34075,70329,NORTH EASTERN
208,ELWAK SOUTH,42,MANDERA SOUTH,9,MANDERA,40209,35061,75270,NORTH EASTERN
209,ELWAK NORTH,42,MANDERA SOUTH,9,MANDERA,14170,13177,27347,NORTH EASTERN
210,SHAMBIR FATUMA,42,MANDERA SOUTH,9,MANDERA,23514,20760,44274,NORTH EASTERN
211,ARABIA,43,MANDERA EAST,9,MANDERA,15378,11891,27269,NORTH EASTERN
212,BULLA MPYA,43,MANDERA EAST,9,MANDERA,19256,17538,36794,NORTH EASTERN
213,KHALALIO,43,MANDERA EAST,9,MANDERA,7518,6304,13822,NORTH EASTERN
214,NEBOI,43,MANDERA EAST,9,MANDERA,6451,5847,12298,NORTH EASTERN
215,TOWNSHIP,43,MANDERA EAST,9,MANDERA,23909,21449,45358,NORTH EASTERN
216,LIBEHIA,44,LAFEY,9,MANDERA,27713,21385,49098,NORTH EASTERN
217,FINO,44,LAFEY,9,MANDERA,9361,7271,16632,NORTH EASTERN
218,LAFEY,44,LAFEY,9,MANDERA,27022,21637,48659,NORTH EASTERN
219,WARANKARA,44,LAFEY,9,MANDERA,14033,10586,24619,NORTH EASTERN
220,ALANGO GOF,44,LAFEY,9,MANDERA,8908,5230,14138,NORTH EASTERN
221,BUTIYE,45,MOYALE,10,MARSABIT,9280,8262,17542,EASTERN
222,SOLOLO,45,MOYALE,10,MARSABIT,4210,4090,8300,EASTERN
223,HEILLU/MANYATTA,45,MOYALE,10,MARSABIT,11077,10075,21152,EASTERN
224,GOLBO,45,MOYALE,10,MARSABIT,15365,13796,29161,EASTERN
225,MOYALE TOWNSHIP,45,MOYALE,10,MARSABIT,6295,6400,12695,EASTERN
226,URAN,45,MOYALE,10,MARSABIT,5284,4470,9754,EASTERN
227,OBBU,45,MOYALE,10,MARSABIT,2778,2417,5195,EASTERN
228,DUKANA,46,NORTH HORR,10,MARSABIT,10576,8052,18628,EASTERN
229,MAIKONA,46,NORTH HORR,10,MARSABIT,10157,9068,19225,EASTERN
230,TURBI,46,NORTH HORR,10,MARSABIT,5593,4743,10336,EASTERN
231,NORTH HORR,46,NORTH HORR,10,MARSABIT,9736,7481,17217,EASTERN
232,ILLERET,46,NORTH HORR,10,MARSABIT,5255,4535,9790,EASTERN
233,SAGANTE/JALDESA,47,SAKU,10,MARSABIT,8386,8372,16758,EASTERN
234,KARARE,47,SAKU,10,MARSABIT,4421,4539,8960,EASTERN
235,MARSABIT CENTRAL,47,SAKU,10,MARSABIT,10498,10286,20784,EASTERN
236,LOIYANGALANI,48,LAISAMIS,10,MARSABIT,8207,8151,16358,EASTERN
237,KARGI/SOUTH HORR,48,LAISAMIS,10,MARSABIT,4682,5071,9753,EASTERN
238,KORR/NGURUNIT,48,LAISAMIS,10,MARSABIT,10337,10968,21305,EASTERN
239,LOGOLOGO,48,LAISAMIS,10,MARSABIT,2586,2558,5144,EASTERN
240,LAISAMIS,48,LAISAMIS,10,MARSABIT,6387,6722,13109,EASTERN
241,WABERA,49,ISIOLO NORTH,11,ISIOLO,8764,8667,17431,EASTERN
242,BULA PESA,49,ISIOLO NORTH,11,ISIOLO,11148,11574,22722,EASTERN
243,CHARI,49,ISIOLO NORTH,11,ISIOLO,2418,2363,4781,EASTERN
244,CHERAB,49,ISIOLO NORTH,11,ISIOLO,7790,7770,15560,EASTERN
245,NGARE MARA,49,ISIOLO NORTH,11,ISIOLO,3110,2410,5520,EASTERN
246,BURAT,49,ISIOLO NORTH,11,ISIOLO,9603,9171,18774,EASTERN
247,OLDONYIRO,49,ISIOLO NORTH,11,ISIOLO,7546,7842,15388,EASTERN
248,GARBATULLA,50,ISIOLO SOUTH,11,ISIOLO,8671,7730,16401,EASTERN
249,KINNA,50,ISIOLO SOUTH,11,ISIOLO,8124,6494,14618,EASTERN
250,SERICHO,50,ISIOLO SOUTH,11,ISIOLO,6519,5580,12099,EASTERN
251,MAUA,51,IGEMBE SOUTH,12,MERU,10956,11661,22617,EASTERN
252,KIEGU/ANTUBOCHIU,51,IGEMBE SOUTH,12,MERU,15782,16503,32285,EASTERN
253,ATHIRU GAITI,51,IGEMBE SOUTH,12,MERU,13488,13243,26731,EASTERN
254,AKACHIU,51,IGEMBE SOUTH,12,MERU,13251,13417,26668,EASTERN
255,KANUNI,51,IGEMBE SOUTH,12,MERU,13337,12912,26249,EASTERN
256,AKIRANG'ONDU,52,IGEMBE CENTRAL,12,MERU,15385,16041,31426,EASTERN
257,ATHIRU RUUJINE,52,IGEMBE CENTRAL,12,MERU,22073,22002,44075,EASTERN
258,IGEMBE EAST,52,IGEMBE CENTRAL,12,MERU,22699,21790,44489,EASTERN
259,NJIA,52,IGEMBE CENTRAL,12,MERU,20863,21896,42759,EASTERN
260,KANGETA,52,IGEMBE CENTRAL,12,MERU,15248,15395,30643,EASTERN
261,ANTUAMBUI,53,IGEMBE NORTH,12,MERU,14426,14805,29231,EASTERN
262,NTUNENE,53,IGEMBE NORTH,12,MERU,9590,9970,19560,EASTERN
263,ANTUBETWE KIONGO,53,IGEMBE NORTH,12,MERU,15938,16266,32204,EASTERN
264,NAATHU,53,IGEMBE NORTH,12,MERU,14381,15174,29555,EASTERN
265,AMWATHI,53,IGEMBE NORTH,12,MERU,21541,22723,44264,EASTERN
266,ATHWANA,54,TIGANIA WEST,12,MERU,8440,9687,18127,EASTERN
267,AKITHII,54,TIGANIA WEST,12,MERU,16567,19079,35646,EASTERN
268,KIANJAI,54,TIGANIA WEST,12,MERU,17682,19192,36874,EASTERN
269,NKOMO,54,TIGANIA WEST,12,MERU,11945,12416,24361,EASTERN
270,MBEU,54,TIGANIA WEST,12,MERU,10347,10625,20972,EASTERN
271,THANGATHA,55,TIGANIA EAST,12,MERU,19864,20326,40190,EASTERN
272,MIKINDURI,55,TIGANIA EAST,12,MERU,16646,17150,33796,EASTERN
273,KIGUCHWA,55,TIGANIA EAST,12,MERU,9285,9887,19172,EASTERN
274,MUTHARA,55,TIGANIA EAST,12,MERU,18117,20911,39028,EASTERN
275,KARAMA,55,TIGANIA EAST,12,MERU,12285,12775,25060,EASTERN
276,MUNICIPALITY,56,NORTH IMENTI,12,MERU,13759,14101,27860,EASTERN
277,NTIMA EAST,56,NORTH IMENTI,12,MERU,10249,10734,20983,EASTERN
278,NTIMA WEST,56,NORTH IMENTI,12,MERU,16653,17113,33766,EASTERN
279,NYAKI WEST,56,NORTH IMENTI,12,MERU,17996,17579,35575,EASTERN
280,NYAKI EAST,56,NORTH IMENTI,12,MERU,15660,15300,30960,EASTERN
281,TIMAU,57,BUURI,12,MERU,17443,16951,34394,EASTERN
282,KISIMA,57,BUURI,12,MERU,15439,14246,29685,EASTERN
283,KIIRUA/NAARI,57,BUURI,12,MERU,13573,13726,27299,EASTERN
284,RUIRI/RWARERA,57,BUURI,12,MERU,9140,9285,18425,EASTERN
285,MWANGANTHIA,58,CENTRAL IMENTI,12,MERU,12316,12477,24793,EASTERN
286,ABOTHUGUCHI CENTRAL,58,CENTRAL IMENTI,12,MERU,16906,17075,33981,EASTERN
287,ABOTHUGUCHI WEST,58,CENTRAL IMENTI,12,MERU,17707,18194,35901,EASTERN
288,KIAGU,58,CENTRAL IMENTI,12,MERU,11157,11086,22243,EASTERN
289,KIBIRICHIA,57,BUURI,12,MERU,12230,12620,24850,EASTERN
290,MITUNGUU,59,SOUTH IMENTI,12,MERU,10825,10010,20835,EASTERN
291,IGOJI EAST,59,SOUTH IMENTI,12,MERU,14549,14366,28915,EASTERN
292,IGOJI WEST,59,SOUTH IMENTI,12,MERU,10084,10328,20412,EASTERN
293,ABOGETA EAST,59,SOUTH IMENTI,12,MERU,17077,16771,33848,EASTERN
294,ABOGETA WEST,59,SOUTH IMENTI,12,MERU,15040,15298,30338,EASTERN
295,NKUENE,59,SOUTH IMENTI,12,MERU,22717,22539,45256,EASTERN
296,MITHERU,60,MAARA,13,THARAKA-NITHI,7586,7723,15309,EASTERN
297,MUTHAMBI,60,MAARA,13,THARAKA-NITHI,9651,9722,19373,EASTERN
298,MWIMBI,60,MAARA,13,THARAKA-NITHI,11463,11472,22935,EASTERN
299,GANGA,60,MAARA,13,THARAKA-NITHI,8643,8844,17487,EASTERN
300,CHOGORIA,60,MAARA,13,THARAKA-NITHI,16044,15977,32021,EASTERN
301,MARIANI,61,CHUKA/IGAMBANG'OMBE,13,THARAKA-NITHI,6967,7156,14123,EASTERN
302,KARINGANI,61,CHUKA/IGAMBANG'OMBE,13,THARAKA-NITHI,11248,11893,23141,EASTERN
303,MAGUMONI,61,CHUKA/IGAMBANG'OMBE,13,THARAKA-NITHI,17826,18672,36498,EASTERN
304,MUGWE,61,CHUKA/IGAMBANG'OMBE,13,THARAKA-NITHI,11762,12423,24185,EASTERN
305,IGAMBANG'OMBE,61,CHUKA/IGAMBANG'OMBE,13,THARAKA-NITHI,14374,15786,30160,EASTERN
306,GATUNGA,62,THARAKA,13,THARAKA-NITHI,12509,13194,25703,EASTERN
307,MUKOTHIMA,62,THARAKA,13,THARAKA-NITHI,11729,12544,24273,EASTERN
308,NKONDI,62,THARAKA,13,THARAKA-NITHI,7498,8076,15574,EASTERN
309,CHIAKARIGA,62,THARAKA,13,THARAKA-NITHI,16665,18014,34679,EASTERN
310,MARIMANTI,62,THARAKA,13,THARAKA-NITHI,14482,15387,29869,EASTERN
311,RUGURU-NGANDORI,63,MANYATTA,14,EMBU,13517,14408,27925,EASTERN
312,KITHIMU,63,MANYATTA,14,EMBU,9329,9670,18999,EASTERN
313,NGINDA,63,MANYATTA,14,EMBU,14162,14349,28511,EASTERN
314,MBETI NORTH,63,MANYATTA,14,EMBU,16747,16721,33468,EASTERN
315,KIRIMANI,63,MANYATTA,14,EMBU,15598,16587,32185,EASTERN
316,GATURI SOUTH,63,MANYATTA,14,EMBU,6720,6824,13544,EASTERN
317,GATURI NORTH,64,RUNYENJES,14,EMBU,11923,12475,24398,EASTERN
318,KAGAARI SOUTH,64,RUNYENJES,14,EMBU,10223,10203,20426,EASTERN
319,CENTRAL,64,RUNYENJES,14,EMBU,11589,12011,23600,EASTERN
320,KAGAARI NORTH,64,RUNYENJES,14,EMBU,12126,12826,24952,EASTERN
321,KYENI NORTH EAST,64,RUNYENJES,14,EMBU,10380,11166,21546,EASTERN
322,KYENI SOUTH,64,RUNYENJES,14,EMBU,13730,13708,27438,EASTERN
323,MWEA,65,MBEERE SOUTH,14,EMBU,14903,15214,30117,EASTERN
324,MAKIMA,65,MBEERE SOUTH,14,EMBU,10841,10450,21291,EASTERN
325,MBETI SOUTH,65,MBEERE SOUTH,14,EMBU,15269,14310,29579,EASTERN
326,MAVURIA,65,MBEERE SOUTH,14,EMBU,17242,16897,34139,EASTERN
327,KIAMBERE,65,MBEERE SOUTH,14,EMBU,7268,7791,15059,EASTERN
328,NTHAWA,66,MBEERE NORTH,14,EMBU,13467,13258,26725,EASTERN
329,MUMINJI,66,MBEERE NORTH,14,EMBU,7942,8786,16728,EASTERN
330,EVURORE,66,MBEERE NORTH,14,EMBU,21326,24256,45582,EASTERN
331,NGOMENI,67,MWINGI NORTH,15,KITUI,8748,9699,18447,EASTERN
332,KYUSO,67,MWINGI NORTH,15,KITUI,18717,21658,40375,EASTERN
333,MUMONI,67,MWINGI NORTH,15,KITUI,15831,18394,34225,EASTERN
334,TSEIKURU,67,MWINGI NORTH,15,KITUI,15775,18061,33836,EASTERN
335,THARAKA,67,MWINGI NORTH,15,KITUI,6120,6964,13084,EASTERN
336,KYOME/THAANA,68,MWINGI WEST,15,KITUI,12206,14068,26274,EASTERN
337,NGUUTANI,68,MWINGI WEST,15,KITUI,12312,14953,27265,EASTERN
338,MIGWANI,68,MWINGI WEST,15,KITUI,11386,12952,24338,EASTERN
339,KIOMO/KYETHANI,68,MWINGI WEST,15,KITUI,12370,13527,25897,EASTERN
340,CENTRAL,68,MWINGI WEST,15,KITUI,9269,9577,18846,EASTERN
341,KIVOU,69,MWINGI CENTRAL,15,KITUI,12023,12863,24886,EASTERN
342,NGUNI,69,MWINGI CENTRAL,15,KITUI,13817,15496,29313,EASTERN
343,NUU,69,MWINGI CENTRAL,15,KITUI,12949,14695,27644,EASTERN
344,MUI,69,MWINGI CENTRAL,15,KITUI,9372,10256,19628,EASTERN
345,WAITA,69,MWINGI CENTRAL,15,KITUI,9966,10924,20890,EASTERN
346,MUTONGUNI,70,KITUI WEST,15,KITUI,15681,18459,34140,EASTERN
347,KAUWI,70,KITUI WEST,15,KITUI,11932,13453,25385,EASTERN
348,MATINYANI,70,KITUI WEST,15,KITUI,11622,12459,24081,EASTERN
349,KWAMUTONGA/KITHUMULA,70,KITUI WEST,15,KITUI,8787,9921,18708,EASTERN
350,KISASI,71,KITUI RURAL,15,KITUI,12714,14045,26759,EASTERN
351,MBITINI,71,KITUI RURAL,15,KITUI,11801,13057,24858,EASTERN
352,KWAVONZA/YATTA,71,KITUI RURAL,15,KITUI,15045,15687,30732,EASTERN
353,KANYANGI,71,KITUI RURAL,15,KITUI,10804,11290,22094,EASTERN
354,MIAMBANI,72,KITUI CENTRAL,15,KITUI,10269,11895,22164,EASTERN
355,TOWNSHIP,72,KITUI CENTRAL,15,KITUI,13190,12826,26016,EASTERN
356,KYANGWITHYA WEST,72,KITUI CENTRAL,15,KITUI,12944,13761,26705,EASTERN
357,MULANGO,72,KITUI CENTRAL,15,KITUI,13656,14917,28573,EASTERN
358,KYANGWITHYA EAST,72,KITUI CENTRAL,15,KITUI,13458,14799,28257,EASTERN
359,ZOMBE/MWITIKA,73,KITUI EAST,15,KITUI,12083,13369,25452,EASTERN
360,NZAMBANI,73,KITUI EAST,15,KITUI,8833,9293,18126,EASTERN
361,CHULUNI,73,KITUI EAST,15,KITUI,10585,11461,22046,EASTERN
362,VOO/KYAMATU,73,KITUI EAST,15,KITUI,10932,12079,23011,EASTERN
363,ENDAU/MALALANI,73,KITUI EAST,15,KITUI,7420,8086,15506,EASTERN
364,MUTITU/KALIKU,73,KITUI EAST,15,KITUI,9167,9931,19098,EASTERN
365,IKANGA/KYATUNE,74,KITUI SOUTH,15,KITUI,17269,18916,36185,EASTERN
366,MUTOMO,74,KITUI SOUTH,15,KITUI,11549,12901,24450,EASTERN
367,MUTHA,74,KITUI SOUTH,15,KITUI,11971,13167,25138,EASTERN
368,IKUTHA,74,KITUI SOUTH,15,KITUI,12755,13421,26176,EASTERN
369,KANZIKO,74,KITUI SOUTH,15,KITUI,8822,9842,18664,EASTERN
370,ATHI,74,KITUI SOUTH,15,KITUI,17133,18304,35437,EASTERN
371,KIVAA,75,MASINGA,16,MACHAKOS,16219,17873,34092,EASTERN
372,MASINGA CENTRAL,75,MASINGA,16,MACHAKOS,15851,17112,32963,EASTERN
373,EKALAKALA,75,MASINGA,16,MACHAKOS,9286,9727,19013,EASTERN
374,MUTHESYA,75,MASINGA,16,MACHAKOS,8398,8755,17153,EASTERN
375,NDITHINI,75,MASINGA,16,MACHAKOS,11351,11368,22719,EASTERN
376,NDALANI,76,YATTA,16,MACHAKOS,14591,15665,30256,EASTERN
377,MATUU,76,YATTA,16,MACHAKOS,13389,13756,27145,EASTERN
378,KITHIMANI,76,YATTA,16,MACHAKOS,16728,16986,33714,EASTERN
379,IKOMBE,76,YATTA,16,MACHAKOS,16354,18329,34683,EASTERN
380,KATANGI,76,YATTA,16,MACHAKOS,10273,11508,21781,EASTERN
381,KANGUNDO NORTH,77,KANGUNDO,16,MACHAKOS,10911,11485,22396,EASTERN
382,KANGUNDO CENTRAL,77,KANGUNDO,16,MACHAKOS,12293,12557,24850,EASTERN
383,KANGUNDO EAST,77,KANGUNDO,16,MACHAKOS,10468,11041,21509,EASTERN
384,KANGUNDO WEST,77,KANGUNDO,16,MACHAKOS,12530,13082,25612,EASTERN
385,TALA,78,MATUNGULU,16,MACHAKOS,12911,13386,26297,EASTERN
386,MATUNGULU NORTH,78,MATUNGULU,16,MACHAKOS,12615,12426,25041,EASTERN
387,MATUNGULU EAST,78,MATUNGULU,16,MACHAKOS,10544,11181,21725,EASTERN
388,MATUNGULU WEST,78,MATUNGULU,16,MACHAKOS,17109,16826,33935,EASTERN
389,KYELENI,78,MATUNGULU,16,MACHAKOS,8851,8887,17738,EASTERN
390,MITABONI,79,KATHIANI,16,MACHAKOS,14401,15654,30055,EASTERN
391,KATHIANI CENTRAL,79,KATHIANI,16,MACHAKOS,11608,12782,24390,EASTERN
392,UPPER KAEWA/IVETI,79,KATHIANI,16,MACHAKOS,13014,13849,26863,EASTERN
393,UPPER KAEWA/KAANI,79,KATHIANI,16,MACHAKOS,10922,11987,22909,EASTERN
394,ATHI RIVER,80,MAVOKO,16,MACHAKOS,27237,24056,51293,EASTERN
395,KINANIE,80,MAVOKO,16,MACHAKOS,10007,7531,17538,EASTERN
396,MUTHWANI,80,MAVOKO,16,MACHAKOS,15416,13101,28517,EASTERN
397,SYOKIMAU,80,MAVOKO,16,MACHAKOS,23466,18688,42154,EASTERN
398,KALAMA,81,MACHAKOS TOWN,16,MACHAKOS,15359,16696,32055,EASTERN
399,MUA,81,MACHAKOS TOWN,16,MACHAKOS,13193,12380,25573,EASTERN
400,MUTITUNI,81,MACHAKOS TOWN,16,MACHAKOS,11368,12368,23736,EASTERN
401,MACHAKOS CENTRAL,81,MACHAKOS TOWN,16,MACHAKOS,16077,16453,32530,EASTERN
402,MUMBUNI NORTH,81,MACHAKOS TOWN,16,MACHAKOS,13842,14477,28319,EASTERN
403,MUVUTI/KIIMA KIMWE,81,MACHAKOS TOWN,16,MACHAKOS,15902,16511,32413,EASTERN
404,KOLA,81,MACHAKOS TOWN,16,MACHAKOS,11708,12877,24585,EASTERN
405,MBIUNI,82,MWALA,16,MACHAKOS,15565,16577,32142,EASTERN
406,MAKUTANO/MWALA,82,MWALA,16,MACHAKOS,15868,16259,32127,EASTERN
407,MASII,82,MWALA,16,MACHAKOS,15781,16586,32367,EASTERN
408,MUTHETHENI,82,MWALA,16,MACHAKOS,10781,12024,22805,EASTERN
409,WAMUNYU,82,MWALA,16,MACHAKOS,12452,13212,25664,EASTERN
410,KIBAUNI,82,MWALA,16,MACHAKOS,8499,9428,17927,EASTERN
411,TULIMANI,83,MBOONI,17,MAKUENI,16913,18437,35350,EASTERN
412,MBOONI,83,MBOONI,17,MAKUENI,16113,17661,33774,EASTERN
413,KITHUNGO/KITUNDU,83,MBOONI,17,MAKUENI,13410,14775,28185,EASTERN
414,KITETA/KISAU,83,MBOONI,17,MAKUENI,17494,19565,37059,EASTERN
415,WAIA-KAKO,83,MBOONI,17,MAKUENI,11254,11828,23082,EASTERN
416,KALAWA,83,MBOONI,17,MAKUENI,12950,14224,27174,EASTERN
417,KASIKEU,84,KILOME,17,MAKUENI,18986,19362,38348,EASTERN
418,MUKAA,84,KILOME,17,MAKUENI,12671,13854,26525,EASTERN
419,KIIMA KIU/KALANZONI,84,KILOME,17,MAKUENI,11675,11316,22991,EASTERN
420,UKIA,85,KAITI,17,MAKUENI,18736,19754,38490,EASTERN
421,KEE,85,KAITI,17,MAKUENI,9921,11104,21025,EASTERN
422,KILUNGU,85,KAITI,17,MAKUENI,16019,17933,33952,EASTERN
423,ILIMA,85,KAITI,17,MAKUENI,12499,14150,26649,EASTERN
424,WOTE,86,MAKUENI,17,MAKUENI,12932,12394,25326,EASTERN
425,MUVAU/KIKUMINI,86,MAKUENI,17,MAKUENI,12203,12274,24477,EASTERN
426,MAVINDINI,86,MAKUENI,17,MAKUENI,11166,12108,23274,EASTERN
427,KITISE/KITHUKI,86,MAKUENI,17,MAKUENI,10611,11443,22054,EASTERN
428,KATHONZWENI,86,MAKUENI,17,MAKUENI,15008,16269,31277,EASTERN
429,NZAUI/KILILI/KALAMBA,86,MAKUENI,17,MAKUENI,17958,19084,37042,EASTERN
430,MBITINI,86,MAKUENI,17,MAKUENI,14546,15802,30348,EASTERN
431,MAKINDU,87,KIBWEZI WEST,17,MAKUENI,20710,21384,42094,EASTERN
432,NGUUMO,87,KIBWEZI WEST,17,MAKUENI,13697,14511,28208,EASTERN
433,KIKUMBULYU NORTH,87,KIBWEZI WEST,17,MAKUENI,10004,10310,20314,EASTERN
434,KIKUMBULYU SOUTH,87,KIBWEZI WEST,17,MAKUENI,12864,13028,25892,EASTERN
435,NGUU/MASUMBA,87,KIBWEZI WEST,17,MAKUENI,11818,11946,23764,EASTERN
436,EMALI/MULALA,87,KIBWEZI WEST,17,MAKUENI,12760,12897,25657,EASTERN
437,MASONGALENI,88,KIBWEZI EAST,17,MAKUENI,15764,16506,32270,EASTERN
438,MTITO ANDEI,88,KIBWEZI EAST,17,MAKUENI,17647,17476,35123,EASTERN
439,THANGE,88,KIBWEZI EAST,17,MAKUENI,16122,16038,32160,EASTERN
440,IVINGONI/NZAMBANI,88,KIBWEZI EAST,17,MAKUENI,16257,16386,32643,EASTERN
441,ENGINEER,89,KINANGOP,18,NYANDARUA,13244,13733,26977,CENTRAL
442,GATHARA,89,KINANGOP,18,NYANDARUA,12944,13712,26656,CENTRAL
443,NORTH KINANGOP,89,KINANGOP,18,NYANDARUA,10350,10548,20898,CENTRAL
444,MURUNGARU,89,KINANGOP,18,NYANDARUA,13103,13817,26920,CENTRAL
445,NJABINI/KIBURU,89,KINANGOP,18,NYANDARUA,10304,10361,20665,CENTRAL
446,NYAKIO,89,KINANGOP,18,NYANDARUA,12374,12766,25140,CENTRAL
447,GITHABAI,89,KINANGOP,18,NYANDARUA,9660,9825,19485,CENTRAL
448,MUGUMU,89,KINANGOP,18,NYANDARUA,12352,13286,25638,CENTRAL
449,WANJOHI,90,KIPIPIRI,18,NYANDARUA,15599,16452,32051,CENTRAL
450,KIPIPIRI,90,KIPIPIRI,18,NYANDARUA,11184,11807,22991,CENTRAL
451,GETA,90,KIPIPIRI,18,NYANDARUA,9785,10474,20259,CENTRAL
452,GITHIORO,90,KIPIPIRI,18,NYANDARUA,9745,10292,20037,CENTRAL
453,KARAU,91,OL KALOU,18,NYANDARUA,12421,13093,25514,CENTRAL
454,KANJUIRI RIDGE,91,OL KALOU,18,NYANDARUA,12882,12952,25834,CENTRAL
455,MIRANGINE,91,OL KALOU,18,NYANDARUA,13198,13858,27056,CENTRAL
456,KIAMBAGA,91,OL KALOU,18,NYANDARUA,8889,9037,17926,CENTRAL
457,RURII,91,OL KALOU,18,NYANDARUA,11737,12215,23952,CENTRAL
458,GATHANJI,92,OL JOROK,18,NYANDARUA,10673,10658,21331,CENTRAL
459,GATIMU,92,OL JOROK,18,NYANDARUA,12959,13382,26341,CENTRAL
460,WERU,92,OL JOROK,18,NYANDARUA,12704,13443,26147,CENTRAL
461,CHARAGITA,92,OL JOROK,18,NYANDARUA,10817,11007,21824,CENTRAL
462,LESHAU/PONDO,93,NDARAGWA,18,NYANDARUA,9162,9904,19066,CENTRAL
463,KIRIITA,93,NDARAGWA,18,NYANDARUA,9709,10450,20159,CENTRAL
464,CENTRAL,93,NDARAGWA,18,NYANDARUA,14709,15251,29960,CENTRAL
465,SHAMATA,93,NDARAGWA,18,NYANDARUA,11648,11793,23441,CENTRAL
466,DEDAN KIMATHI,94,TETU,19,NYERI,10181,10505,20686,CENTRAL
467,WAMAGANA,94,TETU,19,NYERI,14714,16289,31003,CENTRAL
468,AGUTHI-GAAKI,94,TETU,19,NYERI,12880,13751,26631,CENTRAL
469,MWEIGA,95,KIENI,19,NYERI,8500,8764,17264,CENTRAL
470,NAROMORU/KIAMATHANGA,95,KIENI,19,NYERI,13358,12933,26291,CENTRAL
471,MWIYOGO/ENDARASHA,95,KIENI,19,NYERI,9519,9927,19446,CENTRAL
472,MUGUNDA,95,KIENI,19,NYERI,11713,11999,23712,CENTRAL
473,GATARAKWA,95,KIENI,19,NYERI,9540,9350,18890,CENTRAL
474,THIEGU RIVER,95,KIENI,19,NYERI,11092,10712,21804,CENTRAL
475,KABARU,95,KIENI,19,NYERI,11263,10821,22084,CENTRAL
476,GAKAWA,95,KIENI,19,NYERI,13284,13037,26321,CENTRAL
477,RUGURU,96,MATHIRA,19,NYERI,11233,11713,22946,CENTRAL
478,MAGUTU,96,MATHIRA,19,NYERI,9702,10020,19722,CENTRAL
479,IRIA-INI,96,MATHIRA,19,NYERI,13269,14383,27652,CENTRAL
480,KONYU,96,MATHIRA,19,NYERI,10606,11353,21959,CENTRAL
481,KIRIMUKUYU,96,MATHIRA,19,NYERI,13851,15047,28898,CENTRAL
482,KARATINA TOWN,96,MATHIRA,19,NYERI,13187,14483,27670,CENTRAL
483,MAHIGA,97,OTHAYA,19,NYERI,10412,11434,21846,CENTRAL
484,IRIA-INI,97,OTHAYA,19,NYERI,11690,12846,24536,CENTRAL
485,CHINGA,97,OTHAYA,19,NYERI,10662,11237,21899,CENTRAL
486,KARIMA,97,OTHAYA,19,NYERI,8933,10160,19093,CENTRAL
487,GIKONDI,98,MUKURWE-INI,19,NYERI,8977,9556,18533,CENTRAL
488,RUGI,98,MUKURWE-INI,19,NYERI,10062,10637,20699,CENTRAL
489,MUKURWE-INI EAST,98,MUKURWE-INI,19,NYERI,8623,9794,18417,CENTRAL
490,MUKURWE-INI CENTRAL,98,MUKURWE-INI,19,NYERI,12720,13563,26283,CENTRAL
491,KIGANJO/MATHARI,99,NYERI TOWN,19,NYERI,12401,11471,23872,CENTRAL
492,RWARE,99,NYERI TOWN,19,NYERI,13353,11665,25018,CENTRAL
493,GATITU/MURUGURU,99,NYERI TOWN,19,NYERI,10621,11183,21804,CENTRAL
494,RURING'U,99,NYERI TOWN,19,NYERI,10551,11609,22160,CENTRAL
495,KAMAKWA/MUKARO,99,NYERI TOWN,19,NYERI,12827,13592,26419,CENTRAL
496,MUTITHI,100,MWEA,20,KIRINYAGA,13554,13310,26864,CENTRAL
497,KANGAI,100,MWEA,20,KIRINYAGA,9638,9662,19300,CENTRAL
498,THIBA,100,MWEA,20,KIRINYAGA,11504,11715,23219,CENTRAL
499,WAMUMU,100,MWEA,20,KIRINYAGA,8984,8897,17881,CENTRAL
500,NYANGATI,100,MWEA,20,KIRINYAGA,12269,12747,25016,CENTRAL
501,MURINDUKO,100,MWEA,20,KIRINYAGA,14850,13400,28250,CENTRAL
502,GATHIGIRIRI,100,MWEA,20,KIRINYAGA,9414,8923,18337,CENTRAL
503,TEBERE,100,MWEA,20,KIRINYAGA,15685,15960,31645,CENTRAL
504,KABARE,101,GICHUGU,20,KIRINYAGA,18576,19913,38489,CENTRAL
505,BARAGWI,101,GICHUGU,20,KIRINYAGA,9904,10123,20027,CENTRAL
506,NJUKI-INI,101,GICHUGU,20,KIRINYAGA,11985,12205,24190,CENTRAL
507,NGARIAMA,101,GICHUGU,20,KIRINYAGA,8962,9102,18064,CENTRAL
508,KARUMANDI,101,GICHUGU,20,KIRINYAGA,11701,12201,23902,CENTRAL
509,MUKURE,102,NDIA,20,KIRINYAGA,14848,15688,30536,CENTRAL
510,KIINE,102,NDIA,20,KIRINYAGA,19723,21313,41036,CENTRAL
511,KARITI,102,NDIA,20,KIRINYAGA,13753,14190,27943,CENTRAL
512,MUTIRA,103,KIRINYAGA CENTRAL,20,KIRINYAGA,11220,12139,23359,CENTRAL
513,KANYEKINI,103,KIRINYAGA CENTRAL,20,KIRINYAGA,16130,16203,32333,CENTRAL
514,KERUGOYA,103,KIRINYAGA CENTRAL,20,KIRINYAGA,14748,15588,30336,CENTRAL
515,INOI,103,KIRINYAGA CENTRAL,20,KIRINYAGA,13180,14147,27327,CENTRAL
516,KANYENYA-INI,104,KANGEMA,21,MURANG'A,11221,11971,23192,CENTRAL
517,MUGURU,104,KANGEMA,21,MURANG'A,16476,18048,34524,CENTRAL
518,RWATHIA,104,KANGEMA,21,MURANG'A,9209,10063,19272,CENTRAL
519,GITUGI,105,MATHIOYA,21,MURANG'A,15959,17772,33731,CENTRAL
520,KIRU,105,MATHIOYA,21,MURANG'A,16137,17446,33583,CENTRAL
521,KAMACHARIA,105,MATHIOYA,21,MURANG'A,10032,10873,20905,CENTRAL
522,WANGU,106,KIHARU,21,MURANG'A,13708,15190,28898,CENTRAL
523,MUGOIRI,106,KIHARU,21,MURANG'A,13879,15313,29192,CENTRAL
524,MBIRI,106,KIHARU,21,MURANG'A,16335,16836,33171,CENTRAL
525,TOWNSHIP,106,KIHARU,21,MURANG'A,13421,14063,27484,CENTRAL
526,MURARANDIA,106,KIHARU,21,MURANG'A,13915,15028,28943,CENTRAL
527,GATURI,106,KIHARU,21,MURANG'A,16229,17159,33388,CENTRAL
528,KAHUMBU,107,KIGUMO,21,MURANG'A,9222,10364,19586,CENTRAL
529,MUTHITHI,107,KIGUMO,21,MURANG'A,11339,12080,23419,CENTRAL
530,KIGUMO,107,KIGUMO,21,MURANG'A,11078,12242,23320,CENTRAL
531,KANGARI,107,KIGUMO,21,MURANG'A,14467,14728,29195,CENTRAL
532,KINYONA,107,KIGUMO,21,MURANG'A,13700,14546,28246,CENTRAL
533,KIMORORI/WEMPA,108,MARAGWA,21,MURANG'A,16042,16323,32365,CENTRAL
534,MAKUYU,108,MARAGWA,21,MURANG'A,13281,13629,26910,CENTRAL
535,KAMBITI,108,MARAGWA,21,MURANG'A,10689,10506,21195,CENTRAL
536,KAMAHUHA,108,MARAGWA,21,MURANG'A,11642,12547,24189,CENTRAL
537,ICHAGAKI,108,MARAGWA,21,MURANG'A,11253,12000,23253,CENTRAL
538,NGINDA,108,MARAGWA,21,MURANG'A,11804,12556,24360,CENTRAL
539,NG'ARARIA,109,KANDARA,21,MURANG'A,8855,9150,18005,CENTRAL
540,MURUKA,109,KANDARA,21,MURANG'A,11405,12130,23535,CENTRAL
541,KAGUNDU-INI,109,KANDARA,21,MURANG'A,14075,14772,28847,CENTRAL
542,GAICHANJIRU,109,KANDARA,21,MURANG'A,13440,14923,28363,CENTRAL
543,ITHIRU,109,KANDARA,21,MURANG'A,12976,14206,27182,CENTRAL
544,RUCHU,109,KANDARA,21,MURANG'A,15084,15647,30731,CENTRAL
545,ITHANGA,110,GATANGA,21,MURANG'A,9341,10018,19359,CENTRAL
546,KAKUZI/MITUMBIRI,110,GATANGA,21,MURANG'A,15849,15295,31144,CENTRAL
547,MUGUMO-INI,110,GATANGA,21,MURANG'A,12046,11786,23832,CENTRAL
548,KIHUMBU-INI,110,GATANGA,21,MURANG'A,13231,13900,27131,CENTRAL
549,GATANGA,110,GATANGA,21,MURANG'A,11730,12229,23959,CENTRAL
550,KARIARA,110,GATANGA,21,MURANG'A,18790,19382,38172,CENTRAL
551,KIAMWANGI,111,GATUNDU SOUTH,22,KIAMBU,9740,10631,20371,CENTRAL
552,KIGANJO,111,GATUNDU SOUTH,22,KIAMBU,13117,14017,27134,CENTRAL
553,NDARUGU,111,GATUNDU SOUTH,22,KIAMBU,9615,10630,20245,CENTRAL
554,NGENDA,111,GATUNDU SOUTH,22,KIAMBU,22522,23908,46430,CENTRAL
555,GITUAMBA,112,GATUNDU NORTH,22,KIAMBU,13492,14239,27731,CENTRAL
556,GITHOBOKONI,112,GATUNDU NORTH,22,KIAMBU,10332,11083,21415,CENTRAL
557,CHANIA,112,GATUNDU NORTH,22,KIAMBU,12860,13782,26642,CENTRAL
558,MANGU,112,GATUNDU NORTH,22,KIAMBU,12044,12779,24823,CENTRAL
559,MURERA,113,JUJA,22,KIAMBU,7975,7912,15887,CENTRAL
560,THETA,113,JUJA,22,KIAMBU,11318,11816,23134,CENTRAL
561,JUJA,113,JUJA,22,KIAMBU,17298,16836,34134,CENTRAL
562,WITEITHIE,113,JUJA,22,KIAMBU,13357,12420,25777,CENTRAL
563,KALIMONI,113,JUJA,22,KIAMBU,10165,9696,19861,CENTRAL
564,TOWNSHIP,114,THIKA TOWN,22,KIAMBU,19557,19543,39100,CENTRAL
565,KAMENU,114,THIKA TOWN,22,KIAMBU,37250,36899,74149,CENTRAL
566,HOSPITAL,114,THIKA TOWN,22,KIAMBU,12286,13237,25523,CENTRAL
567,GATUANYAGA,114,THIKA TOWN,22,KIAMBU,7556,7378,14934,CENTRAL
568,NGOLIBA,114,THIKA TOWN,22,KIAMBU,6031,5605,11636,CENTRAL
569,GITOTHUA,115,RUIRU,22,KIAMBU,9940,8143,18083,CENTRAL
570,BIASHARA,115,RUIRU,22,KIAMBU,21654,19942,41596,CENTRAL
571,GATONGORA,115,RUIRU,22,KIAMBU,6971,6836,13807,CENTRAL
572,KAHAWA SUKARI,115,RUIRU,22,KIAMBU,4065,4679,8744,CENTRAL
573,KAHAWA WENDANI,115,RUIRU,22,KIAMBU,7940,8771,16711,CENTRAL
574,KIUU,115,RUIRU,22,KIAMBU,23169,23182,46351,CENTRAL
575,MWIKI,115,RUIRU,22,KIAMBU,21609,23151,44760,CENTRAL
576,MWIHOKO,115,RUIRU,22,KIAMBU,5909,6025,11934,CENTRAL
577,GITHUNGURI,116,GITHUNGURI,22,KIAMBU,17941,18437,36378,CENTRAL
578,GITHIGA,116,GITHUNGURI,22,KIAMBU,15221,15690,30911,CENTRAL
579,IKINU,116,GITHUNGURI,22,KIAMBU,11695,11973,23668,CENTRAL
580,NGEWA,116,GITHUNGURI,22,KIAMBU,13110,13182,26292,CENTRAL
581,KOMOTHAI,116,GITHUNGURI,22,KIAMBU,14877,15637,30514,CENTRAL
582,TING'ANG'A,117,KIAMBU,22,KIAMBU,9832,9895,19727,CENTRAL
583,NDUMBERI,117,KIAMBU,22,KIAMBU,17717,18106,35823,CENTRAL
584,RIABAI,117,KIAMBU,22,KIAMBU,12436,13473,25909,CENTRAL
585,TOWNSHIP,117,KIAMBU,22,KIAMBU,13390,13849,27239,CENTRAL
586,CIANDA,118,KIAMBAA,22,KIAMBU,7539,7580,15119,CENTRAL
587,KARURI,118,KIAMBAA,22,KIAMBU,15102,15558,30660,CENTRAL
588,NENDERU,118,KIAMBAA,22,KIAMBU,17551,18302,35853,CENTRAL
589,MUCHATHA,118,KIAMBAA,22,KIAMBU,13197,13347,26544,CENTRAL
590,KIHARA,118,KIAMBAA,22,KIAMBU,19031,17846,36877,CENTRAL
591,GITARU,119,KABETE,22,KIAMBU,14363,14814,29177,CENTRAL
592,MUGUGA,119,KABETE,22,KIAMBU,13471,14056,27527,CENTRAL
593,NYATHUNA,119,KABETE,22,KIAMBU,14228,14543,28771,CENTRAL
594,KABETE,119,KABETE,22,KIAMBU,15261,15396,30657,CENTRAL
595,UTHIRU,119,KABETE,22,KIAMBU,11861,12434,24295,CENTRAL
596,KARAI,120,KIKUYU,22,KIAMBU,10138,10282,20420,CENTRAL
597,NACHU,120,KIKUYU,22,KIAMBU,9137,9518,18655,CENTRAL
598,SIGONA,120,KIKUYU,22,KIAMBU,13293,13530,26823,CENTRAL
599,KIKUYU,120,KIKUYU,22,KIAMBU,15716,16706,32422,CENTRAL
600,KINOO,120,KIKUYU,22,KIAMBU,12899,14183,27082,CENTRAL
601,BIBIRIONI,121,LIMURU,22,KIAMBU,10441,10761,21202,CENTRAL
602,LIMURU CENTRAL,121,LIMURU,22,KIAMBU,15377,15834,31211,CENTRAL
603,NDEIYA,121,LIMURU,22,KIAMBU,12883,13504,26387,CENTRAL
604,LIMURU EAST,121,LIMURU,22,KIAMBU,14447,13901,28348,CENTRAL
605,NGECHA/TIGONI,121,LIMURU,22,KIAMBU,12044,11940,23984,CENTRAL
606,KINALE,122,LARI,22,KIAMBU,12797,13210,26007,CENTRAL
607,KIJABE,122,LARI,22,KIAMBU,13235,14377,27612,CENTRAL
608,NYANDUMA,122,LARI,22,KIAMBU,11438,12016,23454,CENTRAL
609,KAMBURU,122,LARI,22,KIAMBU,9455,9496,18951,CENTRAL
610,LARI/KIRENGA,122,LARI,22,KIAMBU,13708,14163,27871,CENTRAL
611,KAERIS,123,TURKANA NORTH,23,TURKANA,11650,9688,21338,RIFT VALLEY
612,LAKEZONE,123,TURKANA NORTH,23,TURKANA,18217,16072,34289,RIFT VALLEY
613,LAPUR,123,TURKANA NORTH,23,TURKANA,11587,10345,21932,RIFT VALLEY
614,KAALENG/KAIKOR,123,TURKANA NORTH,23,TURKANA,15819,14036,29855,RIFT VALLEY
615,KIBISH,123,TURKANA NORTH,23,TURKANA,11380,10293,21673,RIFT VALLEY
616,NAKALALE,123,TURKANA NORTH,23,TURKANA,8046,7442,15488,RIFT VALLEY
617,KAKUMA,124,TURKANA WEST,23,TURKANA,17250,16289,33539,RIFT VALLEY
618,LOPUR,124,TURKANA WEST,23,TURKANA,24066,21598,45664,RIFT VALLEY
619,LETEA,124,TURKANA WEST,23,TURKANA,22702,20560,43262,RIFT VALLEY
620,SONGOT,124,TURKANA WEST,23,TURKANA,9386,8238,17624,RIFT VALLEY
621,KALOBEYEI,124,TURKANA WEST,23,TURKANA,9442,8830,18272,RIFT VALLEY
622,LOKICHOGIO,124,TURKANA WEST,23,TURKANA,15395,13872,29267,RIFT VALLEY
623,NANAAM,124,TURKANA WEST,23,TURKANA,22570,19641,42211,RIFT VALLEY
624,KERIO DELTA,125,TURKANA CENTRAL,23,TURKANA,17213,16999,34212,RIFT VALLEY
625,KANGATOTHA,125,TURKANA CENTRAL,23,TURKANA,11231,11464,22695,RIFT VALLEY
626,KALOKOL,125,TURKANA CENTRAL,23,TURKANA,9483,9994,19477,RIFT VALLEY
627,LODWAR TOWNSHIP,125,TURKANA CENTRAL,23,TURKANA,17690,17816,35506,RIFT VALLEY
628,KANAMKEMER,125,TURKANA CENTRAL,23,TURKANA,10840,11944,22784,RIFT VALLEY
629,KOTARUK/LOBEI,126,LOIMA,23,TURKANA,16355,15274,31629,RIFT VALLEY
630,TURKWEL,126,LOIMA,23,TURKANA,22722,24677,47399,RIFT VALLEY
631,LOIMA,126,LOIMA,23,TURKANA,9875,9973,19848,RIFT VALLEY
632,LOKIRIAMA/LORENGIPPI,126,LOIMA,23,TURKANA,11128,9928,21056,RIFT VALLEY
633,KAPUTIR,127,TURKANA SOUTH,23,TURKANA,8226,6893,15119,RIFT VALLEY
634,KATILU,127,TURKANA SOUTH,23,TURKANA,22366,19558,41924,RIFT VALLEY
635,LOBOKAT,127,TURKANA SOUTH,23,TURKANA,6245,4883,11128,RIFT VALLEY
636,KALAPATA,127,TURKANA SOUTH,23,TURKANA,12379,11130,23509,RIFT VALLEY
637,LOKICHAR,127,TURKANA SOUTH,23,TURKANA,23377,20856,44233,RIFT VALLEY
638,KAPEDO/NAPEITOM,128,TURKANA EAST,23,TURKANA,13995,11443,25438,RIFT VALLEY
639,KATILIA,128,TURKANA EAST,23,TURKANA,11307,9676,20983,RIFT VALLEY
640,LOKORI/KOCHODIN,128,TURKANA EAST,23,TURKANA,23129,20916,44045,RIFT VALLEY
641,RIWO,129,KAPENGURIA,24,WEST POKOT,13533,13994,27527,RIFT VALLEY
642,KAPENGURIA,129,KAPENGURIA,24,WEST POKOT,14717,15042,29759,RIFT VALLEY
643,MNANGEI,129,KAPENGURIA,24,WEST POKOT,17407,17559,34966,RIFT VALLEY
644,SIYOI,129,KAPENGURIA,24,WEST POKOT,8738,8594,17332,RIFT VALLEY
645,ENDUGH,129,KAPENGURIA,24,WEST POKOT,8733,8769,17502,RIFT VALLEY
646,SOOK,129,KAPENGURIA,24,WEST POKOT,6122,6292,12414,RIFT VALLEY
647,SEKERR,130,SIGOR,24,WEST POKOT,8760,8176,16936,RIFT VALLEY
648,MASOOL,130,SIGOR,24,WEST POKOT,7627,7117,14744,RIFT VALLEY
649,LOMUT,130,SIGOR,24,WEST POKOT,12154,12614,24768,RIFT VALLEY
650,WEI WEI,130,SIGOR,24,WEST POKOT,14289,14342,28631,RIFT VALLEY
651,SUAM,131,KACHELIBA,24,WEST POKOT,12069,11154,23223,RIFT VALLEY
652,KODICH,131,KACHELIBA,24,WEST POKOT,11361,11178,22539,RIFT VALLEY
653,KASEI,131,KACHELIBA,24,WEST POKOT,7116,7649,14765,RIFT VALLEY
654,KAPCHOK,131,KACHELIBA,24,WEST POKOT,11818,11866,23684,RIFT VALLEY
655,KIWAWA,131,KACHELIBA,24,WEST POKOT,13799,14436,28235,RIFT VALLEY
656,ALALE,131,KACHELIBA,24,WEST POKOT,21793,21772,43565,RIFT VALLEY
657,CHEPARERIA,132,POKOT SOUTH,24,WEST POKOT,20421,21142,41563,RIFT VALLEY
658,BATEI,132,POKOT SOUTH,24,WEST POKOT,15187,15586,30773,RIFT VALLEY
659,LELAN,132,POKOT SOUTH,24,WEST POKOT,16485,17042,33527,RIFT VALLEY
660,TAPACH,132,POKOT SOUTH,24,WEST POKOT,12697,13540,26237,RIFT VALLEY
661,LODOKEJEK,133,SAMBURU WEST,25,SAMBURU,6372,7648,14020,RIFT VALLEY
662,SUGUTA MARMAR,133,SAMBURU WEST,25,SAMBURU,5874,6031,11905,RIFT VALLEY
663,MARALAL,133,SAMBURU WEST,25,SAMBURU,18087,18668,36755,RIFT VALLEY
664,LOOSUK,133,SAMBURU WEST,25,SAMBURU,5137,5103,10240,RIFT VALLEY
665,PORRO,133,SAMBURU WEST,25,SAMBURU,5166,5412,10578,RIFT VALLEY
666,EL BARTA,134,SAMBURU NORTH,25,SAMBURU,6811,6864,13675,RIFT VALLEY
667,NACHOLA,134,SAMBURU NORTH,25,SAMBURU,6579,5043,11622,RIFT VALLEY
668,NDOTO,134,SAMBURU NORTH,25,SAMBURU,7416,7496,14912,RIFT VALLEY
669,NYIRO,134,SAMBURU NORTH,25,SAMBURU,10664,8928,19592,RIFT VALLEY
670,ANGATA NANYUKIE,134,SAMBURU NORTH,25,SAMBURU,5307,4440,9747,RIFT VALLEY
671,BAAWA,134,SAMBURU NORTH,25,SAMBURU,5578,6229,11807,RIFT VALLEY
672,WASO,135,SAMBURU EAST,25,SAMBURU,9339,8457,17796,RIFT VALLEY
673,WAMBA WEST,135,SAMBURU EAST,25,SAMBURU,6174,7539,13713,RIFT VALLEY
674,WAMBA EAST,135,SAMBURU EAST,25,SAMBURU,7881,8182,16063,RIFT VALLEY
675,WAMBA NORTH,135,SAMBURU EAST,25,SAMBURU,5618,5904,11522,RIFT VALLEY
676,KAPOMBOI,136,KWANZA,26,TRANS NZOIA,28002,28080,56082,RIFT VALLEY
677,KWANZA,136,KWANZA,26,TRANS NZOIA,27782,27865,55647,RIFT VALLEY
678,KEIYO,136,KWANZA,26,TRANS NZOIA,16382,16915,33297,RIFT VALLEY
679,BIDII,136,KWANZA,26,TRANS NZOIA,10426,11072,21498,RIFT VALLEY
680,CHEPCHOINA,137,ENDEBESS,26,TRANS NZOIA,18501,17984,36485,RIFT VALLEY
681,ENDEBES,137,ENDEBES,26,TRANS NZOIA,11731,11607,23338,RIFT VALLEY
682,MATUMBEI,137,ENDEBESS,26,TRANS NZOIA,15644,15725,31369,RIFT VALLEY
683,KINYORO,138,SABOTI,26,TRANS NZOIA,19729,19916,39645,RIFT VALLEY
684,MATISI,138,SABOTI,26,TRANS NZOIA,21463,19199,40662,RIFT VALLEY
685,TUWANI,138,SABOTI,26,TRANS NZOIA,20168,19494,39662,RIFT VALLEY
686,SABOTI,138,SABOTI,26,TRANS NZOIA,17642,17346,34988,RIFT VALLEY
687,MACHEWA,138,SABOTI,26,TRANS NZOIA,9845,10154,19999,RIFT VALLEY
688,KIMININI,139,KIMININI,26,TRANS NZOIA,16333,17431,33764,RIFT VALLEY
689,WAITALUK,139,KIMININI,26,TRANS NZOIA,19801,20576,40377,RIFT VALLEY
690,SIRENDE,139,KIMININI,26,TRANS NZOIA,11548,12129,23677,RIFT VALLEY
691,HOSPITAL,139,KIMININI,26,TRANS NZOIA,15090,15144,30234,RIFT VALLEY
692,SIKHENDU,139,KIMININI,26,TRANS NZOIA,11695,12434,24129,RIFT VALLEY
693,NABISWA,139,KIMININI,26,TRANS NZOIA,18795,19936,38731,RIFT VALLEY
694,SINYERERE,140,CHERANGANY,26,TRANS NZOIA,12816,13074,25890,RIFT VALLEY
695,MAKUTANO,140,CHERANGANY,26,TRANS NZOIA,9297,9065,18362,RIFT VALLEY
696,KAPLAMAI,140,CHERANGANY,26,TRANS NZOIA,12403,12854,25257,RIFT VALLEY
697,MOTOSIET,140,CHERANGANY,26,TRANS NZOIA,16411,16774,33185,RIFT VALLEY
698,CHERANGANY/SUWERWA,140,CHERANGANY,26,TRANS NZOIA,17938,18618,36556,RIFT VALLEY
699,CHEPSIRO/KIPTOROR,140,CHERANGANY,26,TRANS NZOIA,14625,14934,29559,RIFT VALLEY
700,SITATUNGA,140,CHERANGANY,26,TRANS NZOIA,13103,13261,26364,RIFT VALLEY
701,MOI'S BRIDGE,141,SOY,27,UASIN GISHU,14781,15361,30142,RIFT VALLEY
702,KAPKURES,141,SOY,27,UASIN GISHU,9339,9737,19076,RIFT VALLEY
703,ZIWA,141,SOY,27,UASIN GISHU,15607,15826,31433,RIFT VALLEY
704,SEGERO/BARSOMBE,141,SOY,27,UASIN GISHU,12708,12872,25580,RIFT VALLEY
705,KIPSOMBA,141,SOY,27,UASIN GISHU,9657,9526,19183,RIFT VALLEY
706,SOY,141,SOY,27,UASIN GISHU,12400,12668,25068,RIFT VALLEY
707,KUINET/KAPSUSWA,141,SOY,27,UASIN GISHU,6062,6088,12150,RIFT VALLEY
708,NGENYILEL,142,TURBO,27,UASIN GISHU,15224,15581,30805,RIFT VALLEY
709,TAPSAGOI,142,TURBO,27,UASIN GISHU,14760,15752,30512,RIFT VALLEY
710,KAMAGUT,142,TURBO,27,UASIN GISHU,13870,14420,28290,RIFT VALLEY
711,KIPLOMBE,142,TURBO,27,UASIN GISHU,27470,26189,53659,RIFT VALLEY
712,KAPSAOS,142,TURBO,27,UASIN GISHU,14287,14306,28593,RIFT VALLEY
713,HURUMA,142,TURBO,27,UASIN GISHU,20114,18431,38545,RIFT VALLEY
714,TEMBELIO,143,MOIBEN,27,UASIN GISHU,13817,14204,28021,RIFT VALLEY
715,SERGOIT,143,MOIBEN,27,UASIN GISHU,8212,8008,16220,RIFT VALLEY
716,KARUNA/MEIBEKI,143,MOIBEN,27,UASIN GISHU,13249,12799,26048,RIFT VALLEY
717,MOIBEN,143,MOIBEN,27,UASIN GISHU,12864,12910,25774,RIFT VALLEY
718,KIMUMU,143,MOIBEN,27,UASIN GISHU,31673,29292,60965,RIFT VALLEY
719,KAPSOYA,144,AINABKOI,27,UASIN GISHU,16121,17317,33438,RIFT VALLEY
720,KAPTAGAT,144,AINABKOI,27,UASIN GISHU,18010,18163,36173,RIFT VALLEY
721,AINABKOI/OLARE,144,AINABKOI,27,UASIN GISHU,16854,16577,33431,RIFT VALLEY
722,SIMAT/KAPSERET,145,KAPSERET,27,UASIN GISHU,15598,15432,31030,RIFT VALLEY
723,KIPKENYO,145,KAPSERET,27,UASIN GISHU,10138,10229,20367,RIFT VALLEY
724,NGERIA,145,KAPSERET,27,UASIN GISHU,8603,8744,17347,RIFT VALLEY
725,MEGUN,145,KAPSERET,27,UASIN GISHU,6557,6279,12836,RIFT VALLEY
726,LANGAS,145,KAPSERET,27,UASIN GISHU,26377,24664,51041,RIFT VALLEY
727,RACECOURSE,146,KESSES,27,UASIN GISHU,11168,10860,22028,RIFT VALLEY
728,CHEPTIRET/KIPCHAMO,146,KESSES,27,UASIN GISHU,13826,13831,27657,RIFT VALLEY
729,TULWET/CHIYAT,146,KESSES,27,UASIN GISHU,20791,20293,41084,RIFT VALLEY
730,TARAKWA,146,KESSES,27,UASIN GISHU,18853,18830,37683,RIFT VALLEY
731,KAPYEGO,147,MARAKWET EAST,28,ELGEYO-MARAKWET,8658,8399,17057,RIFT VALLEY
732,SAMBIRIR,147,MARAKWET EAST,28,ELGEYO-MARAKWET,11020,11725,22745,RIFT VALLEY
733,ENDO,147,MARAKWET EAST,28,ELGEYO-MARAKWET,11734,12164,23898,RIFT VALLEY
734,EMBOBUT/EMBULOT,147,MARAKWET EAST,28,ELGEYO-MARAKWET,7396,7653,15049,RIFT VALLEY
735,LELAN,148,MARAKWET WEST,28,ELGEYO-MARAKWET,10208,9903,20111,RIFT VALLEY
736,SENGWER,148,MARAKWET WEST,28,ELGEYO-MARAKWET,9465,9438,18903,RIFT VALLEY
737,CHERAGANY/CHEBORORWA,148,MARAKWET WEST,28,ELGEYO-MARAKWET,9171,9001,18172,RIFT VALLEY
738,MOIBEN/KUSERWO,148,MARAKWET WEST,28,ELGEYO-MARAKWET,9571,9706,19277,RIFT VALLEY
739,KAPSOWAR,148,MARAKWET WEST,28,ELGEYO-MARAKWET,12473,12950,25423,RIFT VALLEY
740,ARROR,148,MARAKWET WEST,28,ELGEYO-MARAKWET,3193,3295,6488,RIFT VALLEY
741,KIMARINY,149,KEIYO NORTH,28,ELGEYO-MARAKWET,12343,12714,25057,RIFT VALLEY
742,EMSOO,149,KEIYO NORTH,28,ELGEYO-MARAKWET,4860,4742,9602,RIFT VALLEY
743,TAMBACH,149,KEIYO NORTH,28,ELGEYO-MARAKWET,7835,8095,15930,RIFT VALLEY
744,KAPCHEMUTWA,149,KEIYO NORTH,28,ELGEYO-MARAKWET,11401,11725,23126,RIFT VALLEY
745,KAPTARAKWA,150,KEIYO SOUTH,28,ELGEYO-MARAKWET,9272,9797,19069,RIFT VALLEY
746,CHEPKORIO,150,KEIYO SOUTH,28,ELGEYO-MARAKWET,11677,11672,23349,RIFT VALLEY
747,SOY NORTH,150,KEIYO SOUTH,28,ELGEYO-MARAKWET,7291,7166,14457,RIFT VALLEY
748,SOY SOUTH,150,KEIYO SOUTH,28,ELGEYO-MARAKWET,10266,10104,20370,RIFT VALLEY
749,KABIEMIT,150,KEIYO SOUTH,28,ELGEYO-MARAKWET,9495,9475,18970,RIFT VALLEY
750,METKEI,150,KEIYO SOUTH,28,ELGEYO-MARAKWET,6407,6538,12945,RIFT VALLEY
751,SONGHOR/SOBA,151,TINDERET,29,NANDI,20241,19693,39934,RIFT VALLEY
752,TINDERET,151,TINDERET,29,NANDI,14237,13659,27896,RIFT VALLEY
753,CHEMILIL/CHEMASE,151,TINDERET,29,NANDI,7409,7070,14479,RIFT VALLEY
754,KAPSIMOTWO,151,TINDERET,29,NANDI,9472,8910,18382,RIFT VALLEY
755,KIBWARENG,152,ALDAI,29,NANDI,11113,11694,22807,RIFT VALLEY
756,TERIK,152,ALDAI,29,NANDI,10111,10345,20456,RIFT VALLEY
757,KEMELOI-MARABA,152,ALDAI,29,NANDI,17125,17960,35085,RIFT VALLEY
758,KOBUJOI,152,ALDAI,29,NANDI,13118,13421,26539,RIFT VALLEY
759,KAPTUMOI/KABOI,152,ALDAI,29,NANDI,12242,12222,24464,RIFT VALLEY
760,KOYO/NDURIO,152,ALDAI,29,NANDI,10041,9864,19905,RIFT VALLEY
761,NANDI HILLS,153,NANDI HILLS,29,NANDI,16945,16600,33545,RIFT VALLEY
762,CHEPKUNYUK,153,NANDI HILLS,29,NANDI,19051,17724,36775,RIFT VALLEY
763,OLLESSOS,153,NANDI HILLS,29,NANDI,9820,9576,19396,RIFT VALLEY
764,KAPCHORUA,153,NANDI HILLS,29,NANDI,9086,8732,17818,RIFT VALLEY
765,CHEMUNDU/KAPNG'ETUNY,154,CHESUMEI,29,NANDI,12622,12781,25403,RIFT VALLEY
766,KOSIRAI,154,CHESUMEI,29,NANDI,12603,13138,25741,RIFT VALLEY
767,LELMOK/NGECHEK,154,CHESUMEI,29,NANDI,11687,11667,23354,RIFT VALLEY
768,KAPTEL/KAMOIYWO,154,CHESUMEI,29,NANDI,15928,15447,31375,RIFT VALLEY
769,KIPTUIYA,154,CHESUMEI,29,NANDI,11887,12992,24879,RIFT VALLEY
770,CHEPKUMIA,155,EMGWEN,29,NANDI,10457,10826,21283,RIFT VALLEY
771,KAPKANGANI,155,EMGWEN,29,NANDI,11620,12374,23994,RIFT VALLEY
772,KAPSABET,155,EMGWEN,29,NANDI,17976,17986,35962,RIFT VALLEY
773,KILIBWONI,155,EMGWEN,29,NANDI,24574,24271,48845,RIFT VALLEY
774,CHETERWAI,156,MOSOP,29,NANDI,9411,9533,18944,RIFT VALLEY
775,KIPKAREN,156,MOSOP,29,NANDI,9564,9583,19147,RIFT VALLEY
776,KURGUNG/SURUNGAI,156,MOSOP,29,NANDI,9048,9177,18225,RIFT VALLEY
777,KABIYET,156,MOSOP,29,NANDI,9548,9714,19262,RIFT VALLEY
778,NDALAT,156,MOSOP,29,NANDI,9220,9431,18651,RIFT VALLEY
779,KABISANGA,156,MOSOP,29,NANDI,9568,9461,19029,RIFT VALLEY
780,SANGALO/KEBULONIK,156,MOSOP,29,NANDI,10764,10626,21390,RIFT VALLEY
781,TIRIOKO,157,TIATY,30,BARINGO,12368,11301,23669,RIFT VALLEY
782,KOLLOWA,157,TIATY,30,BARINGO,9980,9519,19499,RIFT VALLEY
783,RIBKWO,157,TIATY,30,BARINGO,7384,7188,14572,RIFT VALLEY
784,SILALE,157,TIATY,30,BARINGO,12859,9088,21947,RIFT VALLEY
785,LOIYAMOROK,157,TIATY,30,BARINGO,7228,6657,13885,RIFT VALLEY
786,TANGULBEI/KOROSSI,157,TIATY,30,BARINGO,9091,9299,18390,RIFT VALLEY
787,CHURO/AMAYA,157,TIATY,30,BARINGO,10979,10248,21227,RIFT VALLEY
788,BARWESSA,158,BARINGO NORTH,30,BARINGO,11848,12138,23986,RIFT VALLEY
789,KABARTONJO,158,BARINGO NORTH,30,BARINGO,9559,9533,19092,RIFT VALLEY
790,SAIMO/KIPSARAM,158,BARINGO NORTH,30,BARINGO,10202,10844,21046,RIFT VALLEY
791,SAIMO/SOI,158,BARINGO NORTH,30,BARINGO,8756,9058,17814,RIFT VALLEY
792,BARTABWA,158,BARINGO NORTH,30,BARINGO,5862,5989,11851,RIFT VALLEY
793,KABARNET,159,BARINGO CENTRAL,30,BARINGO,11466,11964,23430,RIFT VALLEY
794,SACHO,159,BARINGO CENTRAL,30,BARINGO,7473,7757,15230,RIFT VALLEY
795,TENGES,159,BARINGO CENTRAL,30,BARINGO,4756,4811,9567,RIFT VALLEY
796,EWALEL/CHAPCHAP,159,BARINGO CENTRAL,30,BARINGO,8173,8848,17021,RIFT VALLEY
797,KAPROPITA,159,BARINGO CENTRAL,30,BARINGO,7520,8712,16232,RIFT VALLEY
798,MARIGAT,160,BARINGO SOUTH,30,BARINGO,13810,13859,27669,RIFT VALLEY
799,ILCHAMUS,160,BARINGO SOUTH,30,BARINGO,7931,8069,16000,RIFT VALLEY
800,MOCHONGOI,160,BARINGO SOUTH,30,BARINGO,14014,13685,27699,RIFT VALLEY
801,MUKUTAN,160,BARINGO SOUTH,30,BARINGO,4770,4733,9503,RIFT VALLEY
802,MOGOTIO,161,MOGOTIO,30,BARINGO,13850,13943,27793,RIFT VALLEY
803,EMINING,161,MOGOTIO,30,BARINGO,8147,8361,16508,RIFT VALLEY
804,KISANANA,161,MOGOTIO,30,BARINGO,8412,8246,16658,RIFT VALLEY
805,LEMBUS,162,ELDAMA RAVINE,30,BARINGO,10536,10604,21140,RIFT VALLEY
806,LEMBUS KWEN,162,ELDAMA RAVINE,30,BARINGO,10116,10091,20207,RIFT VALLEY
807,RAVINE,162,ELDAMA RAVINE,30,BARINGO,8364,8662,17026,RIFT VALLEY
808,MUMBERES/MAJI MAZURI,162,ELDAMA RAVINE,30,BARINGO,9572,9309,18881,RIFT VALLEY
809,LEMBUS/PERKERRA,162,ELDAMA RAVINE,30,BARINGO,7896,7975,15871,RIFT VALLEY
810,KOIBATEK,162,ELDAMA RAVINE,30,BARINGO,6159,5989,12148,RIFT VALLEY
811,OL-MORAN,163,LAIKIPIA WEST,31,LAIKIPIA,8633,9098,17731,RIFT VALLEY
812,RUMURUTI TOWNSHIP,163,LAIKIPA WEST,31,LAIKIPIA,10495,11135,21630,RIFT VALLEY
813,GITHIGA,163,LAIKIPIA WEST,31,LAIKIPIA,13613,14489,28102,RIFT VALLEY
814,MARMANET,163,LAIKIPIA WEST,31,LAIKIPIA,21156,21473,42629,RIFT VALLEY
815,IGWAMITI,163,LAIKIPIA WEST,31,LAIKIPIA,34021,35470,69491,RIFT VALLEY
816,SALAMA,163,LAIKIPIA WEST,31,LAIKIPIA,11823,12053,23876,RIFT VALLEY
817,NGOBIT,164,LAIKIPIA EAST,31,LAIKIPIA,12021,11957,23978,RIFT VALLEY
818,TIGITHI,164,LAIKIPIA EAST,31,LAIKIPIA,13646,13416,27062,RIFT VALLEY
819,THINGITHU,164,LAIKIPIA EAST,31,LAIKIPIA,10303,10533,20836,RIFT VALLEY
820,NANYUKI,164,LAIKIPIA EAST,31,LAIKIPIA,14751,13734,28485,RIFT VALLEY
821,UMANDE,164,LAIKIPIA EAST,31,LAIKIPIA,8168,8033,16201,RIFT VALLEY
822,SOSIAN,165,LAIKIPIA NORTH,31,LAIKIPIA,12902,13175,26077,RIFT VALLEY
823,SEGERA,165,LAIKIPIA NORTH,31,LAIKIPIA,8138,7864,16002,RIFT VALLEY
824,MUGOGODO WEST,165,LAIKIPIA NORTH,31,LAIKIPIA,6999,6716,13715,RIFT VALLEY
825,MUGOGODO EAST,165,LAIKIPIA NORTH,31,LAIKIPIA,11956,11456,23412,RIFT VALLEY
826,MARIASHONI,166,MOLO,32,NAKURU,6619,5835,12454,RIFT VALLEY
827,ELBURGON,166,MOLO,32,NAKURU,21928,21510,43438,RIFT VALLEY
828,TURI,166,MOLO,32,NAKURU,12577,12871,25448,RIFT VALLEY
829,MOLO,166,MOLO,32,NAKURU,21130,21968,43098,RIFT VALLEY
830,MAU NAROK,167,NJORO,32,NAKURU,17534,17895,35429,RIFT VALLEY
831,MAUCHE,167,NJORO,32,NAKURU,17226,16818,34044,RIFT VALLEY
832,KIHINGO,167,NJORO,32,NAKURU,12790,13817,26607,RIFT VALLEY
833,NESSUIT,167,NJORO,32,NAKURU,6929,6559,13488,RIFT VALLEY
834,LARE,167,NJORO,32,NAKURU,8735,9127,17862,RIFT VALLEY
835,NJORO,167,NJORO,32,NAKURU,28449,28980,57429,RIFT VALLEY
836,BIASHARA,168,NAIVASHA,32,NAKURU,7691,8001,15692,RIFT VALLEY
837,HELLS GATE,168,NAIVASHA,32,NAKURU,19554,19655,39209,RIFT VALLEY
838,LAKE VIEW,168,NAIVASHA,32,NAKURU,9949,10133,20082,RIFT VALLEY
839,MAAI MAHIU,168,NAIVASHA,32,NAKURU,15020,14776,29796,RIFT VALLEY
840,MAIELA,168,NAIVASHA,32,NAKURU,13933,13565,27498,RIFT VALLEY
841,OLKARIA,168,NAIVASHA,32,NAKURU,13011,12426,25437,RIFT VALLEY
842,NAIVASHA EAST,168,NAIVASHA,32,NAKURU,10261,10623,20884,RIFT VALLEY
843,VIWANDA,168,NAIVASHA,32,NAKURU,22316,23227,45543,RIFT VALLEY
844,GILGIL,169,GILGIL,32,NAKURU,25498,22105,47603,RIFT VALLEY
845,ELEMENTAITA,169,GILGIL,32,NAKURU,13621,13883,27504,RIFT VALLEY
846,MBARUK/EBURRU,169,GILGIL,32,NAKURU,16388,17007,33395,RIFT VALLEY
847,MALEWA WEST,169,GILGIL,32,NAKURU,11991,9924,21915,RIFT VALLEY
848,MURINDAT,169,GILGIL,32,NAKURU,10850,10835,21685,RIFT VALLEY
849,AMALO,170,KURESOI SOUTH,32,NAKURU,10735,10351,21086,RIFT VALLEY
850,KERINGET,170,KURESOI SOUTH,32,NAKURU,16868,16681,33549,RIFT VALLEY
851,KIPTAGICH,170,KURESOI SOUTH,32,NAKURU,13482,12711,26193,RIFT VALLEY
852,TINET,170,KURESOI SOUTH,32,NAKURU,17546,17061,34607,RIFT VALLEY
853,KIPTORORO,171,KURESOI NORTH,32,NAKURU,18937,18653,37590,RIFT VALLEY
854,NYOTA,171,KURESOI NORTH,32,NAKURU,20118,19337,39455,RIFT VALLEY
855,SIRIKWA,171,KURESOI NORTH,32,NAKURU,8447,8595,17042,RIFT VALLEY
856,KAMARA,171,KURESOI NORTH,32,NAKURU,15202,14761,29963,RIFT VALLEY
857,SUBUKIA,172,SUBUKIA,32,NAKURU,15739,16503,32242,RIFT VALLEY
858,WASEGES,172,SUBUKIA,32,NAKURU,13542,13803,27345,RIFT VALLEY
859,KABAZI,172,SUBUKIA,32,NAKURU,17273,17618,34891,RIFT VALLEY
860,MENENGAI WEST,173,RONGAI,32,NAKURU,14087,13794,27881,RIFT VALLEY
861,SOIN,173,RONGAI,32,NAKURU,12930,12039,24969,RIFT VALLEY
862,VISOI,173,RONGAI,32,NAKURU,15841,15527,31368,RIFT VALLEY
863,MOSOP,173,RONGAI,32,NAKURU,13689,13358,27047,RIFT VALLEY
864,SOLAI,173,RONGAI,32,NAKURU,9345,9522,18867,RIFT VALLEY
865,DUNDORI,174,BAHATI,32,NAKURU,11786,12530,24316,RIFT VALLEY
866,KABATINI,174,BAHATI,32,NAKURU,14536,15093,29629,RIFT VALLEY
867,KIAMAINA,174,BAHATI,32,NAKURU,15272,16073,31345,RIFT VALLEY
868,LANET/UMOJA,174,BAHATI,32,NAKURU,13639,14372,28011,RIFT VALLEY
869,BAHATI,174,BAHATI,32,NAKURU,14999,15966,30965,RIFT VALLEY
870,BARUT,175,NAKURU TOWN WEST,32,NAKURU,3906,3498,7404,RIFT VALLEY
871,LONDON,175,NAKURU TOWN WEST,32,NAKURU,12783,10800,23583,RIFT VALLEY
872,KAPTEMBWO,175,NAKURU TOWN WEST,32,NAKURU,38012,32340,70352,RIFT VALLEY
873,KAPKURES,175,NAKURU TOWN WEST,32,NAKURU,4586,4370,8956,RIFT VALLEY
874,RHODA,175,NAKURU TOWN WEST,32,NAKURU,12045,12551,24596,RIFT VALLEY
875,SHAABAB,175,NAKURU TOWN WEST,32,NAKURU,8653,9336,17989,RIFT VALLEY
876,BIASHARA,176,NAKURU TOWN EAST,32,NAKURU,17270,18646,35916,RIFT VALLEY
877,KIVUMBINI,176,NAKURU TOWN EAST,32,NAKURU,10221,10353,20574,RIFT VALLEY
878,FLAMINGO,176,NAKURU TOWN EAST,32,NAKURU,14990,16743,31733,RIFT VALLEY
879,MENENGAI,176,NAKURU TOWN EAST,32,NAKURU,16204,16722,32926,RIFT VALLEY
880,NAKURU EAST,176,NAKURU TOWN EAST,32,NAKURU,17894,17501,35395,RIFT VALLEY
881,KILGORIS CENTRAL,177,KILGORIS,33,NAROK,20724,21253,41977,RIFT VALLEY
882,KEYIAN,177,KILGORIS,33,NAROK,13364,13309,26673,RIFT VALLEY
883,ANGATA BARIKOI,177,KILGORIS,33,NAROK,12419,12526,24945,RIFT VALLEY
884,SHANKOE,177,KILGORIS,33,NAROK,14434,14111,28545,RIFT VALLEY
885,KIMENTET,177,KILGORIS,33,NAROK,11908,10935,22843,RIFT VALLEY
886,LOLGORIAN,177,KILGORIS,33,NAROK,17711,17723,35434,RIFT VALLEY
887,ILKERIN,178,EMURUA DIKIRR,33,NAROK,13122,13235,26357,RIFT VALLEY
888,OLOLMASANI,178,EMURUA DIKIRR,33,NAROK,13292,13481,26773,RIFT VALLEY
889,MOGONDO,178,EMURUA DIKIRR,33,NAROK,8724,8856,17580,RIFT VALLEY
890,KAPSASIAN,178,EMURUA DIKIRR,33,NAROK,11467,11938,23405,RIFT VALLEY
891,OLPOSIMORU,179,NAROK NORTH,33,NAROK,10099,9936,20035,RIFT VALLEY
892,OLOKURTO,179,NAROK NORTH,33,NAROK,10592,10453,21045,RIFT VALLEY
893,NAROK TOWN,179,NAROK NORTH,33,NAROK,24486,23031,47517,RIFT VALLEY
894,NKARETA,179,NAROK NORTH,33,NAROK,10347,9859,20206,RIFT VALLEY
895,OLORROPIL,179,NAROK NORTH,33,NAROK,15590,13972,29562,RIFT VALLEY
896,MELILI,179,NAROK NORTH,33,NAROK,19418,17805,37223,RIFT VALLEY
897,MOSIRO,180,NAROK EAST,33,NAROK,13998,13465,27463,RIFT VALLEY
898,ILDAMAT,180,NAROK EAST,33,NAROK,8152,7491,15643,RIFT VALLEY
899,KEEKONYOKIE,180,NAROK EAST,33,NAROK,10463,10150,20613,RIFT VALLEY
900,SUSWA,180,NAROK EAST,33,NAROK,9767,9470,19237,RIFT VALLEY
901,MAJI MOTO/NAROOSURA,181,NAROK SOUTH,33,NAROK,19214,20316,39530,RIFT VALLEY
902,OLOLULUNG'A,181,NAROK SOUTH,33,NAROK,17705,16928,34633,RIFT VALLEY
903,MELELO,181,NAROK SOUTH,33,NAROK,17614,17455,35069,RIFT VALLEY
904,LOITA,181,NAROK SOUTH,33,NAROK,11649,11224,22873,RIFT VALLEY
905,SOGOO,181,NAROK SOUTH,33,NAROK,14532,14211,28743,RIFT VALLEY
906,SAGAMIAN,181,NAROK SOUTH,33,NAROK,10595,10462,21057,RIFT VALLEY
907,ILMOTIOK,182,NAROK WEST,33,NAROK,23055,23080,46135,RIFT VALLEY
908,MARA,182,NAROK WEST,33,NAROK,16796,16405,33201,RIFT VALLEY
909,SIANA,182,NAROK WEST,33,NAROK,17175,16920,34095,RIFT VALLEY
910,NAIKARRA,182,NAROK WEST,33,NAROK,10615,11893,22508,RIFT VALLEY
911,OLKERI,183,KAJIADO NORTH,34,KAJIADO,20864,20777,41641,RIFT VALLEY
912,ONGAT RONGAI,183,KAJIADO NORTH,34,KAJIADO,21673,23005,44678,RIFT VALLEY
913,NKAIMURUNYA,183,KAJIADO NORTH,34,KAJIADO,28224,27182,55406,RIFT VALLEY
914,OLOOLUA,183,KAJIADO NORTH,34,KAJIADO,16935,16819,33754,RIFT VALLEY
915,NGONG,183,KAJIADO NORTH,34,KAJIADO,8910,9181,18091,RIFT VALLEY
916,PURKO,184,KAJIADO CENTRAL,34,KAJIADO,2569,2773,5342,RIFT VALLEY
917,ILDAMAT,184,KAJIADO CENTRAL,34,KAJIADO,5028,4962,9990,RIFT VALLEY
918,DALALEKUTUK,184,KAJIADO CENTRAL,34,KAJIADO,13751,14079,27830,RIFT VALLEY
919,MATAPATO NORTH,184,KAJIADO CENTRAL,34,KAJIADO,14339,15491,29830,RIFT VALLEY
920,MATAPATO SOUTH,184,KAJIADO CENTRAL,34,KAJIADO,15349,15812,31161,RIFT VALLEY
921,KAPUTIEI NORTH,185,KAJIADO EAST,34,KAJIADO,15568,13920,29488,RIFT VALLEY
922,KITENGELA,185,KAJIADO EAST,34,KAJIADO,15787,14876,30663,RIFT VALLEY
923,OLOOSIRKON/SHOLINKE,185,KAJIADO EAST,34,KAJIADO,17989,16186,34175,RIFT VALLEY
924,KENYEWA-POKA,185,KAJIADO EAST,34,KAJIADO,12173,12386,24559,RIFT VALLEY
925,IMARORO,185,KAJIADO EAST,34,KAJIADO,8802,8294,17096,RIFT VALLEY
926,KEEKONYOKIE,186,KAJIADO WEST,34,KAJIADO,19622,19290,38912,RIFT VALLEY
927,OLOODOKILAN,186,KAJIADO WEST,34,KAJIADO,8344,8126,16470,RIFT VALLEY
928,MAGADI,186,KAJIADO WEST,34,KAJIADO,13038,12413,25451,RIFT VALLEY
929,EWUASO KEDONG,186,KAJIADO WEST,34,KAJIADO,14775,14812,29587,RIFT VALLEY
930,MOSIRO,186,KAJIADO WEST,34,KAJIADO,2567,3125,5692,RIFT VALLEY
931,ENTONET/LENGISM,187,KAJIADO SOUTH,34,KAJIADO,11755,12024,23779,RIFT VALLEY
932,IMBIRIKANI/ESSELENGE,187,KAJIADO SOUTH,34,KAJIADO,9403,9214,18617,RIFT VALLEY
933,KUKU,187,KAJIADO SOUTH,34,KAJIADO,18760,18387,37147,RIFT VALLEY
934,ROMBO,187,KAJIADO SOUTH,34,KAJIADO,18545,19059,37604,RIFT VALLEY
935,KIMANA,187,KAJIADO SOUTH,34,KAJIADO,10373,9976,20349,RIFT VALLEY
936,LONDIANI,188,KIPKELION EAST,35,KERICHO,12098,12455,24553,RIFT VALLEY
937,KEDOWA/KIMUGUL,188,KIPKELION EAST,35,KERICHO,18099,18231,36330,RIFT VALLEY
938,CHEPSEON,188,KIPKELION EAST,35,KERICHO,18601,17683,36284,RIFT VALLEY
939,TENDENO/SORGET,188,KIPKELION EAST,35,KERICHO,7434,7231,14665,RIFT VALLEY
940,KUNYAK,189,KIPKELION WEST,35,KERICHO,9248,8753,18001,RIFT VALLEY
941,KAMASIAN,189,KIPKELION WEST,35,KERICHO,10064,10015,20079,RIFT VALLEY
942,KIPKELION,189,KIPKELION WEST,35,KERICHO,12630,12871,25501,RIFT VALLEY
943,CHILCHILA,189,KIPKELION WEST,35,KERICHO,15696,15481,31177,RIFT VALLEY
944,KAPSOIT,190,AINAMOI,35,KERICHO,13826,14019,27845,RIFT VALLEY
945,AINAMOI,190,AINAMOI,35,KERICHO,8644,8733,17377,RIFT VALLEY
946,KAPKUGERWET,190,AINAMOI,35,KERICHO,14666,13679,28345,RIFT VALLEY
947,KIPCHEBOR,190,AINAMOI,35,KERICHO,15556,14209,29765,RIFT VALLEY
948,KIPCHIMCHIM,190,AINAMOI,35,KERICHO,6083,5777,11860,RIFT VALLEY
949,KAPSAOS,190,AINAMOI,35,KERICHO,14568,14553,29121,RIFT VALLEY
950,KISIARA,191,BURETI,35,KERICHO,10521,10881,21402,RIFT VALLEY
951,TEBESONIK,191,BURETI,35,KERICHO,10543,10369,20912,RIFT VALLEY
952,CHEBOIN,191,BURETI,35,KERICHO,11265,11569,22834,RIFT VALLEY
953,CHEMOSOT,191,BURETI,35,KERICHO,13206,13347,26553,RIFT VALLEY
954,LITEIN,191,BURETI,35,KERICHO,12991,13284,26275,RIFT VALLEY
955,CHEPLANGET,191,BURETI,35,KERICHO,13270,13670,26940,RIFT VALLEY
956,KAPKATET,191,BURETI,35,KERICHO,11306,11427,22733,RIFT VALLEY
957,WALDAI,192,BELGUT,35,KERICHO,16676,16998,33674,RIFT VALLEY
958,KABIANGA,192,BELGUT,35,KERICHO,17604,17487,35091,RIFT VALLEY
959,CHEPTORORIET/SERETUT,192,BELGUT,35,KERICHO,10273,10376,20649,RIFT VALLEY
960,CHAIK,192,BELGUT,35,KERICHO,11230,8721,19951,RIFT VALLEY
961,KAPSUSER,192,AINAMOI,35,KERICHO,9808,9547,19355,RIFT VALLEY
962,SIGOWET,193,SIGOWET/SOIN,35,KERICHO,17882,18293,36175,RIFT VALLEY
963,KAPLELARTET,193,SIGOWET/SOIN,35,KERICHO,15834,15919,31753,RIFT VALLEY
964,SOLIAT,193,SIGOWET/SOIN,35,KERICHO,8105,8019,16124,RIFT VALLEY
965,SOIN,193,SIGOWET/SOIN,35,KERICHO,10673,10399,21072,RIFT VALLEY
966,NDANAI/ABOSI,194,SOTIK,36,BOMET,18156,18993,37149,RIFT VALLEY
967,CHEMAGEL,194,SOTIK,36,BOMET,15984,16250,32234,RIFT VALLEY
968,KIPSONOI,194,SOTIK,36,BOMET,15910,16798,32708,RIFT VALLEY
969,KAPLETUNDO,194,SOTIK,36,BOMET,20006,20362,40368,RIFT VALLEY
970,RONGENA/CHEBILAT,194,SOTIK,36,BOMET,12624,12206,24830,RIFT VALLEY
971,KONG'ASIS,195,CHEPALUNGU,36,BOMET,14131,15327,29458,RIFT VALLEY
972,NYANGORES,195,CHEPALUNGU,36,BOMET,17197,18223,35420,RIFT VALLEY
973,SIGOR,195,CHEPALUNGU,36,BOMET,15779,17039,32818,RIFT VALLEY
974,CHEBUNYO,195,CHEPALUNGU,36,BOMET,17081,17841,34922,RIFT VALLEY
975,SIONGIROI,195,CHEPALUNGU,36,BOMET,15175,16040,31215,RIFT VALLEY
976,MERIGI,196,BOMET EAST,36,BOMET,14512,14550,29062,RIFT VALLEY
977,KEMBU,196,BOMET EAST,36,BOMET,13279,13713,26992,RIFT VALLEY
978,LONGISA,196,BOMET EAST,36,BOMET,13772,14593,28365,RIFT VALLEY
979,KIPRERES,196,BOMET EAST,36,BOMET,11213,12059,23272,RIFT VALLEY
980,CHEMANER,196,BOMET EAST,36,BOMET,9397,9836,19233,RIFT VALLEY
981,SILIBWET TOWNSHIP,197,BOMET CENTRAL,36,BOMET,14023,13994,28017,RIFT VALLEY
982,NDARAWETA,197,BOMET CENTRAL,36,BOMET,11099,10960,22059,RIFT VALLEY
983,SIGORWET,197,BOMET CENTRAL,36,BOMET,10835,10960,21795,RIFT VALLEY
984,CHESEON,197,BOMET CENTRAL,36,BOMET,17368,17108,34476,RIFT VALLEY
985,MUTARAKWA,197,BOMET CENTRAL,36,BOMET,10106,10573,20679,RIFT VALLEY
986,CHEPCHABAS,198,KONOIN,36,BOMET,15042,10662,25704,RIFT VALLEY
987,KIMULOT,198,KONOIN,36,BOMET,11682,11053,22735,RIFT VALLEY
988,MOGOGOSIEKI,198,KONOIN,36,BOMET,15407,15327,30734,RIFT VALLEY
989,BOITO,198,KONOIN,36,BOMET,16497,15467,31964,RIFT VALLEY
990,EMBOMOS,198,KONOIN,36,BOMET,17033,16887,33920,RIFT VALLEY
991,MAUTUMA,199,LUGARI,37,KAKAMEGA,12273,12809,25082,WESTERN
992,LUGARI,199,LUGARI,37,KAKAMEGA,15189,16192,31381,WESTERN
993,LUMAKANDA,199,LUGARI,37,KAKAMEGA,14756,15199,29955,WESTERN
994,CHEKALINI,199,LUGARI,37,KAKAMEGA,9485,10220,19705,WESTERN
995,CHEVAYWA,199,LUGARI,37,KAKAMEGA,16123,17022,33145,WESTERN
996,LUANDETI,199,LUGARI,37,KAKAMEGA,13348,14398,27746,WESTERN
997,LIKUYANI,200,LIKUYANI,37,KAKAMEGA,13376,13867,27243,WESTERN
998,SANGO,200,LIKUYANI,37,KAKAMEGA,11069,11784,22853,WESTERN
999,KONGONI,200,LIKUYANI,37,KAKAMEGA,11374,12327,23701,WESTERN
1000,NZOIA,200,LIKUYANI,37,KAKAMEGA,14504,15817,30321,WESTERN
1001,SINOKO,200,LIKUYANI,37,KAKAMEGA,10321,10698,21019,WESTERN
1002,WEST KABRAS,201,MALAVA,37,KAKAMEGA,12723,13391,26114,WESTERN
1003,CHEMUCHE,201,MALAVA,37,KAKAMEGA,14380,15365,29745,WESTERN
1004,EAST KABRAS,201,MALAVA,37,KAKAMEGA,10964,11695,22659,WESTERN
1005,BUTALI/CHEGULO,201,MALAVA,37,KAKAMEGA,15462,16414,31876,WESTERN
1006,MANDA/SHIVANGA,201,MALAVA,37,KAKAMEGA,15681,16513,32194,WESTERN
1007,SHIRUGU/MUGAI,201,MALAVA,37,KAKAMEGA,12120,12935,25055,WESTERN
1008,SOUTH KABRAS,201,MALAVA,37,KAKAMEGA,18383,19140,37523,WESTERN
1009,BUTSOTSO EAST,202,LURAMBI,37,KAKAMEGA,11259,11968,23227,WESTERN
1010,SOUTH BUTSOTSO,202,LURAMBI,37,KAKAMEGA,8297,9080,17377,WESTERN
1011,CENTRAL BUTSOTSO,202,LURAMBI,37,KAKAMEGA,12405,13339,25744,WESTERN
1012,SHIEYWE,202,LURAMBI,37,KAKAMEGA,24223,24081,48304,WESTERN
1013,MAHIAKALO,202,LURAMBI,37,KAKAMEGA,6075,5992,12067,WESTERN
1014,SHIRERE,202,LURAMBI,37,KAKAMEGA,16958,16552,33510,WESTERN
1015,INGOTSE-MATIHA,203,NAVAKHOLO,37,KAKAMEGA,10732,11359,22091,WESTERN
1016,SHINOYI-SHIKOMARI-ES,203,NAVAKHOLO,37,KAKAMEGA,12223,13129,25352,WESTERN
1017,BUNYALA WEST,203,NAVAKHOLO,37,KAKAMEGA,18165,20242,38407,WESTERN
1018,BUNYALA EAST,203,NAVAKHOLO,37,KAKAMEGA,10750,11372,22122,WESTERN
1019,BUNYALA CENTRAL,203,NAVAKHOLO,37,KAKAMEGA,14194,14999,29193,WESTERN
1020,MUMIAS CENTRAL,204,MUMIAS WEST,37,KAKAMEGA,18063,19151,37214,WESTERN
1021,MUMIAS NORTH,204,MUMIAS WEST,37,KAKAMEGA,8010,7755,15765,WESTERN
1022,ETENJE,204,MUMIAS WEST,37,KAKAMEGA,13338,14824,28162,WESTERN
1023,MUSANDA,204,MUMIAS WEST,37,KAKAMEGA,14565,16156,30721,WESTERN
1024,LUSHEYA/LUBINU,205,MUMIAS EAST,37,KAKAMEGA,18213,19396,37609,WESTERN
1025,MALAHA/ISONGO/MAKUNG,205,MUMIAS EAST,37,KAKAMEGA,14681,16323,31004,WESTERN
1026,EAST WANGA,205,MUMIAS EAST,37,KAKAMEGA,15619,16724,32343,WESTERN
1027,KOYONZO,206,MATUNGU,37,KAKAMEGA,16928,18884,35812,WESTERN
1028,KHOLERA,206,MATUNGU,37,KAKAMEGA,13856,14965,28821,WESTERN
1029,KHALABA,206,MATUNGU,37,KAKAMEGA,9559,10219,19778,WESTERN
1030,MAYONI,206,MATUNGU,37,KAKAMEGA,14903,15681,30584,WESTERN
1031,NAMAMALI,206,MATUNGU,37,KAKAMEGA,15282,16286,31568,WESTERN
1032,MARAMA WEST,207,BUTERE,37,KAKAMEGA,15006,16244,31250,WESTERN
1033,MARAMA CENTRAL,207,BUTERE,37,KAKAMEGA,21393,23324,44717,WESTERN
1034,MARENYO/SHIANDA,207,BUTERE,37,KAKAMEGA,10978,12087,23065,WESTERN
1035,MARAMA NORTH,207,BUTERE,37,KAKAMEGA,9812,10984,20796,WESTERN
1036,MARAMA SOUTH,207,BUTERE,37,KAKAMEGA,9480,10472,19952,WESTERN
1037,KISA NORTH,208,KHWISERO,37,KAKAMEGA,9166,10134,19300,WESTERN
1038,KISA EAST,208,KHWISERO,37,KAKAMEGA,9307,10598,19905,WESTERN
1039,KISA WEST,208,KHWISERO,37,KAKAMEGA,10052,11178,21230,WESTERN
1040,KISA CENTRAL,208,KHWISERO,37,KAKAMEGA,19886,22314,42200,WESTERN
1041,ISUKHA NORTH,209,SHINYALU,37,KAKAMEGA,11961,11535,23496,WESTERN
1042,MURHANDA,209,SHINYALU,37,KAKAMEGA,13549,14736,28285,WESTERN
1043,ISUKHA CENTRAL,209,SHINYALU,37,KAKAMEGA,16536,18009,34545,WESTERN
1044,ISUKHA SOUTH,209,SHINYALU,37,KAKAMEGA,16932,18875,35807,WESTERN
1045,ISUKHA EAST,209,SHINYALU,37,KAKAMEGA,8697,9233,17930,WESTERN
1046,ISUKHA WEST,209,SHINYALU,37,KAKAMEGA,9133,10279,19412,WESTERN
1047,IDAKHO SOUTH,210,IKOLOMANI,37,KAKAMEGA,9450,11467,20917,WESTERN
1048,IDAKHO EAST,210,IKOLOMANI,37,KAKAMEGA,12661,14096,26757,WESTERN
1049,IDAKHO NORTH,210,IKOLOMANI,37,KAKAMEGA,12377,13484,25861,WESTERN
1050,IDAKHO CENTRAL,210,IKOLOMANI,37,KAKAMEGA,14772,16362,31134,WESTERN
1051,LUGAGA/WAMULUMA,211,VIHIGA,38,VIHIGA,13852,15301,29153,WESTERN
1052,SOUTH MARAGOLI,211,VIHIGA,38,VIHIGA,9172,10121,19293,WESTERN
1053,CENTRAL MARAGOLI,211,VIHIGA,38,VIHIGA,11363,12007,23370,WESTERN
1054,MUNGOMA,211,VIHIGA,38,VIHIGA,9286,10514,19800,WESTERN
1055,LYAYWA/IZAVA,212,SABATIA,38,VIHIGA,12224,13381,25605,WESTERN
1056,SABATIA WEST,212,SABATIA,38,VIHIGA,10063,11438,21501,WESTERN
1057,CHAVAKALI,212,SABATIA,38,VIHIGA,8856,9596,18452,WESTERN
1058,NORTH MARAGOLI,212,SABATIA,38,VIHIGA,8854,9633,18487,WESTERN
1059,WODANGA,212,SABATIA,38,VIHIGA,10189,11751,21940,WESTERN
1060,BUSALI,212,SABATIA,38,VIHIGA,11252,12441,23693,WESTERN
1061,SHIRU,213,HAMISI,38,VIHIGA,10618,11716,22334,WESTERN
1062,GISAMBAI,213,HAMISI,38,VIHIGA,10234,11218,21452,WESTERN
1063,SHAMAKHOKHO,213,HAMISI,38,VIHIGA,13119,14416,27535,WESTERN
1064,BANJA,213,HAMISI,38,VIHIGA,10516,12019,22535,WESTERN
1065,MUHUDU,213,HAMISI,38,VIHIGA,7798,8861,16659,WESTERN
1066,TAMBUA,213,HAMISI,38,VIHIGA,9097,9592,18689,WESTERN
1067,JEPKOYAI,213,HAMISI,38,VIHIGA,9090,9965,19055,WESTERN
1068,LUANDA TOWNSHIP,214,LUANDA,38,VIHIGA,7027,7376,14403,WESTERN
1069,WEMILABI,214,LUANDA,38,VIHIGA,10792,12254,23046,WESTERN
1070,MWIBONA,214,LUANDA,38,VIHIGA,8347,9013,17360,WESTERN
1071,LUANDA SOUTH,214,LUANDA,38,VIHIGA,9502,10492,19994,WESTERN
1072,EMABUNGO,214,LUANDA,38,VIHIGA,9928,11191,21119,WESTERN
1073,NORTH EAST BUNYORE,215,EMUHAYA,38,VIHIGA,14012,15979,29991,WESTERN
1074,CENTRAL BUNYORE,215,EMUHAYA,38,VIHIGA,12667,14649,27316,WESTERN
1075,WEST BUNYORE,215,EMUHAYA,38,VIHIGA,14860,16980,31840,WESTERN
1076,CHEPTAIS,216,MT ELGON,39,BUNGOMA,14249,14539,28788,WESTERN
1077,CHESIKAKI,216,MT ELGON,39,BUNGOMA,11882,12180,24062,WESTERN
1078,CHEPYUK,216,MT ELGON,39,BUNGOMA,13055,12387,25442,WESTERN
1079,KAPKATENY,216,MT ELGON,39,BUNGOMA,14369,14299,28668,WESTERN
1080,KAPTAMA,216,MT ELGON,39,BUNGOMA,16778,16777,33555,WESTERN
1081,ELGON,216,MT ELGON,39,BUNGOMA,15786,16076,31862,WESTERN
1082,NAMWELA,217,SIRISIA,39,BUNGOMA,13316,14237,27553,WESTERN
1083,MALAKISI/SOUTH KULIS,217,SIRISIA,39,BUNGOMA,17065,18002,35067,WESTERN
1084,LWANDANYI,217,SIRISIA,39,BUNGOMA,19455,20347,39802,WESTERN
1085,KABUCHAI/CHWELE,218,KABUCHAI,39,BUNGOMA,17280,18575,35855,WESTERN
1086,WEST NALONDO,218,KABUCHAI,39,BUNGOMA,16276,16854,33130,WESTERN
1087,BWAKE/LUUYA,218,KABUCHAI,39,BUNGOMA,16665,17475,34140,WESTERN
1088,MUKUYUNI,218,KABUCHAI,39,BUNGOMA,18509,19479,37988,WESTERN
1089,SOUTH BUKUSU,219,BUMULA,39,BUNGOMA,11123,12012,23135,WESTERN
1090,BUMULA,219,BUMULA,39,BUNGOMA,15333,16590,31923,WESTERN
1091,KHASOKO,219,BUMULA,39,BUNGOMA,6756,7279,14035,WESTERN
1092,KABULA,219,BUMULA,39,BUNGOMA,10007,10749,20756,WESTERN
1093,KIMAETI,219,BUMULA,39,BUNGOMA,17605,18934,36539,WESTERN
1094,WEST BUKUSU,219,BUMULA,39,BUNGOMA,9669,10333,20002,WESTERN
1095,SIBOTI,219,BUMULA,39,BUNGOMA,15734,16773,32507,WESTERN
1096,BUKEMBE WEST,220,KANDUYI,39,BUNGOMA,9983,10328,20311,WESTERN
1097,BUKEMBE EAST,220,KANDUYI,39,BUNGOMA,13251,13498,26749,WESTERN
1098,TOWNSHIP,220,KANDUYI,39,BUNGOMA,9946,9071,19017,WESTERN
1099,KHALABA,220,KANDUYI,39,BUNGOMA,11657,12842,24499,WESTERN
1100,MUSIKOMA,220,KANDUYI,39,BUNGOMA,18725,19208,37933,WESTERN
1101,EAST SANG'ALO,220,KANDUYI,39,BUNGOMA,15632,16656,32288,WESTERN
1102,MARAKARY/TUUTI,220,KANDUYI,39,BUNGOMA,17210,18571,35781,WESTERN
1103,WEST SANG'ALO,220,KANDUYI,39,BUNGOMA,16083,17040,33123,WESTERN
1104,MIHUU,221,WEBUYE EAST,39,BUNGOMA,18589,19219,37808,WESTERN
1105,NDIVISI,221,WEBUYE EAST,39,BUNGOMA,19314,20477,39791,WESTERN
1106,MARAKA,221,WEBUYE EAST,39,BUNGOMA,11876,11999,23875,WESTERN
1107,MISIKHU,222,WEBUYE WEST,39,BUNGOMA,15429,15953,31382,WESTERN
1108,SITIKHO,222,WEBUYE WEST,39,BUNGOMA,14712,15343,30055,WESTERN
1109,MATULO,222,WEBUYE WEST,39,BUNGOMA,16486,17965,34451,WESTERN
1110,BOKOLI,222,WEBUYE WEST,39,BUNGOMA,15972,16919,32891,WESTERN
1111,KIBINGEI,223,KIMILILI,39,BUNGOMA,16834,17624,34458,WESTERN
1112,KIMILILI,223,KIMILILI,39,BUNGOMA,17382,18885,36267,WESTERN
1113,MAENI,223,KIMILILI,39,BUNGOMA,11798,12411,24209,WESTERN
1114,KAMUKUYWA,223,KIMILILI,39,BUNGOMA,18604,19284,37888,WESTERN
1115,MBAKALO,224,TONGAREN,39,BUNGOMA,15614,16615,32229,WESTERN
1116,NAITIRI/KABUYEFWE,224,TONGAREN,39,BUNGOMA,18477,19546,38023,WESTERN
1117,MILIMA,224,TONGAREN,39,BUNGOMA,16119,17233,33352,WESTERN
1118,NDALU,224,TONGAREN,39,BUNGOMA,10457,10691,21148,WESTERN
1119,TONGAREN,224,TONGAREN,39,BUNGOMA,16515,17392,33907,WESTERN
1120,SOYSAMBU/MITUA,224,TONGAREN,39,BUNGOMA,13971,14848,28819,WESTERN
1121,MALABA CENTRAL,225,TESO NORTH,40,BUSIA,12350,12842,25192,WESTERN
1122,MALABA NORTH,225,TESO NORTH,40,BUSIA,6745,7020,13765,WESTERN
1123,ANG'URAI SOUTH,225,TESO NORTH,40,BUSIA,10026,10765,20791,WESTERN
1124,ANG'URAI NORTH,225,TESO NORTH,40,BUSIA,11281,12119,23400,WESTERN
1125,ANG'URAI EAST,225,TESO NORTH,40,BUSIA,7747,7802,15549,WESTERN
1126,MALABA SOUTH,225,TESO NORTH,40,BUSIA,9271,9979,19250,WESTERN
1127,ANGOROM,226,TESO SOUTH,40,BUSIA,12700,13462,26162,WESTERN
1128,CHAKOL SOUTH,226,TESO SOUTH,40,BUSIA,14828,15879,30707,WESTERN
1129,CHAKOL NORTH,226,TESO SOUTH,40,BUSIA,8878,9777,18655,WESTERN
1130,AMUKURA WEST,226,TESO SOUTH,40,BUSIA,8557,8866,17423,WESTERN
1131,AMUKURA EAST,226,TESO SOUTH,40,BUSIA,11237,12120,23357,WESTERN
1132,AMUKURA CENTRAL,226,TESO SOUTH,40,BUSIA,10008,10748,20756,WESTERN
1133,NAMBALE,227,NAMBALE,40,BUSIA,15649,16644,32293,WESTERN
1134,BUKHAYO NORTH/WALATS,227,NAMBALE,40,BUSIA,10792,11667,22459,WESTERN
1135,BUKHAYO EAST,227,NAMBALE,40,BUSIA,10399,11297,21696,WESTERN
1136,BUKHAYO CENTRAL,227,NAMBALE,40,BUSIA,8648,9541,18189,WESTERN
1137,BUKHAYO WEST,228,MATAYOS,40,BUSIA,16384,17096,33480,WESTERN
1138,MAYENJE,228,MATAYOS,40,BUSIA,4448,4722,9170,WESTERN
1139,MATAYOS SOUTH,228,MATAYOS,40,BUSIA,14551,16323,30874,WESTERN
1140,BUSIBWABO,228,MATAYOS,40,BUSIA,5360,5968,11328,WESTERN
1141,BURUMBA,228,MATAYOS,40,BUSIA,12835,13658,26493,WESTERN
1142,MARACHI WEST,229,BUTULA,40,BUSIA,9371,10840,20211,WESTERN
1143,KINGANDOLE,229,BUTULA,40,BUSIA,8602,9668,18270,WESTERN
1144,MARACHI CENTRAL,229,BUTULA,40,BUSIA,9247,10569,19816,WESTERN
1145,MARACHI EAST,229,BUTULA,40,BUSIA,9832,11033,20865,WESTERN
1146,MARACHI NORTH,229,BUTULA,40,BUSIA,11370,12684,24054,WESTERN
1147,ELUGULU,229,BUTULA,40,BUSIA,8602,10052,18654,WESTERN
1148,NAMBOBOTO/NAMBUKU,230,FUNYULA,40,BUSIA,13147,14996,28143,WESTERN
1149,NANGINA,230,FUNYULA,40,BUSIA,9387,10806,20193,WESTERN
1150,AGENG'A NANGUBA,230,FUNYULA,40,BUSIA,12262,13116,25378,WESTERN
1151,BWIRI,230,FUNYULA,40,BUSIA,9464,10322,19786,WESTERN
1152,BUNYALA CENTRAL,231,BUDALANGI,40,BUSIA,4786,5595,10381,WESTERN
1153,BUNYALA NORTH,231,BUDALANGI,40,BUSIA,10007,10941,20948,WESTERN
1154,BUNYALA WEST,231,BUDALANGI,40,BUSIA,10203,11034,21237,WESTERN
1155,BUNYALA SOUTH,231,BUDALANGI,40,BUSIA,6723,7434,14157,WESTERN
1156,WEST UGENYA,232,UGENYA,41,SIAYA,14019,16306,30325,NYANZA
1157,UKWALA,232,UGENYA,41,SIAYA,9724,11546,21270,NYANZA
1158,NORTH UGENYA,232,UGENYA,41,SIAYA,12690,14391,27081,NYANZA
1159,EAST UGENYA,232,UGENYA,41,SIAYA,14006,16252,30258,NYANZA
1160,SIDINDI,233,UGUNJA,41,SIAYA,11411,13116,24527,NYANZA
1161,SIGOMERE,233,UGUNJA,41,SIAYA,13648,15984,29632,NYANZA
1162,UGUNJA,233,UGUNJA,41,SIAYA,18182,21031,39213,NYANZA
1163,USONGA,234,ALEGO USONGA,41,SIAYA,6267,7334,13601,NYANZA
1164,WEST ALEGO,234,ALEGO USONGA,41,SIAYA,14766,17468,32234,NYANZA
1165,CENTRAL ALEGO,234,ALEGO USONGA,41,SIAYA,14433,16560,30993,NYANZA
1166,SIAYA TOWNSHIP,234,ALEGO USONGA,41,SIAYA,15433,16819,32252,NYANZA
1167,NORTH ALEGO,234,ALEGO USONGA,41,SIAYA,15011,16766,31777,NYANZA
1168,SOUTH EAST ALEGO,234,ALEGO USONGA,41,SIAYA,21590,24796,46386,NYANZA
1169,NORTH GEM,235,GEM,41,SIAYA,16772,18232,35004,NYANZA
1170,WEST GEM,235,GEM,41,SIAYA,11193,12288,23481,NYANZA
1171,CENTRAL GEM,235,GEM,41,SIAYA,11476,12378,23854,NYANZA
1172,YALA TOWNSHIP,235,GEM,41,SIAYA,11012,12139,23151,NYANZA
1173,EAST GEM,235,GEM,41,SIAYA,11677,13087,24764,NYANZA
1174,SOUTH GEM,235,GEM,41,SIAYA,14397,16024,30421,NYANZA
1175,WEST YIMBO,236,BONDO,41,SIAYA,14193,14310,28503,NYANZA
1176,CENTRAL SAKWA,236,BONDO,41,SIAYA,9885,10208,20093,NYANZA
1177,SOUTH SAKWA,236,BONDO,41,SIAYA,11186,12074,23260,NYANZA
1178,YIMBO EAST,236,BONDO,41,SIAYA,13171,14018,27189,NYANZA
1179,WEST SAKWA,236,BONDO,41,SIAYA,12161,13152,25313,NYANZA
1180,NORTH SAKWA,236,BONDO,41,SIAYA,15874,17290,33164,NYANZA
1181,EAST ASEMBO,237,RARIEDA,41,SIAYA,15635,17251,32886,NYANZA
1182,WEST ASEMBO,237,RARIEDA,41,SIAYA,15654,17418,33072,NYANZA
1183,NORTH UYOMA,237,RARIEDA,41,SIAYA,10407,10838,21245,NYANZA
1184,SOUTH UYOMA,237,RARIEDA,41,SIAYA,9336,10200,19536,NYANZA
1185,WEST UYOMA,237,RARIEDA,41,SIAYA,13441,14378,27819,NYANZA
1186,KAJULU,238,KISUMU EAST,42,KISUMU,19812,21064,40876,NYANZA
1187,KOLWA EAST,238,KISUMU EAST,42,KISUMU,10307,10981,21288,NYANZA
1188,MANYATTA 'B',238,KISUMU EAST,42,KISUMU,14219,13733,27952,NYANZA
1189,NYALENDA 'A',238,KISUMU EAST,42,KISUMU,14829,13440,28269,NYANZA
1190,KOLWA CENTRAL,238,KISUMU EAST,42,KISUMU,15632,16107,31739,NYANZA
1191,SOUTH WEST KISUMU,239,KISUMU WEST,42,KISUMU,10666,11460,22126,NYANZA
1192,CENTRAL KISUMU,239,KISUMU WEST,42,KISUMU,20523,17605,38128,NYANZA
1193,KISUMU NORTH,239,KISUMU WEST,42,KISUMU,12151,12739,24890,NYANZA
1194,WEST KISUMU,239,KISUMU WEST,42,KISUMU,10609,11538,22147,NYANZA
1195,NORTH WEST KISUMU,239,KISUMU WEST,42,KISUMU,11787,12168,23955,NYANZA
1196,RAILWAYS,240,KISUMU CENTRAL,42,KISUMU,17852,17072,34924,NYANZA
1197,MIGOSI,240,KISUMU CENTRAL,42,KISUMU,9182,10644,19826,NYANZA
1198,SHAURI MOYO/KALOLENI,240,KISUMU CENTRAL,42,KISUMU,6932,7874,14806,NYANZA
1199,MARKET MILIMANI,240,KISUMU CENTRAL,42,KISUMU,9534,9368,18902,NYANZA
1200,KONDELE,240,KISUMU CENTRAL,42,KISUMU,23502,24502,48004,NYANZA
1201,NYALENDA 'B',240,KISUMU CENTRAL,42,KISUMU,16189,16241,32430,NYANZA
1202,WEST SEME,241,SEME,42,KISUMU,13319,15137,28456,NYANZA
1203,CENTRAL SEME,241,SEME,42,KISUMU,10888,12325,23213,NYANZA
1204,EAST SEME,241,SEME,42,KISUMU,10191,11497,21688,NYANZA
1205,NORTH SEME,241,SEME,42,KISUMU,12020,13428,25448,NYANZA
1206,EAST KANO/WAWIDHI,242,NYANDO,42,KISUMU,8247,9087,17334,NYANZA
1207,AWASI/ONJIKO,242,NYANDO,42,KISUMU,12495,13576,26071,NYANZA
1208,AHERO,242,NYANDO,42,KISUMU,17468,18838,36306,NYANZA
1209,KABONYO/KANYAGWAL,242,NYANDO,42,KISUMU,12130,12935,25065,NYANZA
1210,KOBURA,242,NYANDO,42,KISUMU,17122,19139,36261,NYANZA
1211,MIWANI,243,MUHORONI,42,KISUMU,10481,8945,19426,NYANZA
1212,OMBEYI,243,MUHORONI,42,KISUMU,12752,13555,26307,NYANZA
1213,MASOGO/NYANG'OMA,243,MUHORONI,42,KISUMU,15740,16756,32496,NYANZA
1214,CHEMILIL,243,MUHORONI,42,KISUMU,16941,16137,33078,NYANZA
1215,MUHORONI KORU,243,MUHORONI,42,KISUMU,17891,16566,34457,NYANZA
1216,SOUTH WEST NYAKACH,244,NYAKACH,42,KISUMU,8095,9227,17322,NYANZA
1217,NORTH NYAKACH,244,NYAKACH,42,KISUMU,15040,16789,31829,NYANZA
1218,CENTRAL NYAKACH,244,NYAKACH,42,KISUMU,12771,14189,26960,NYANZA
1219,WEST NYAKACH,244,NYAKACH,42,KISUMU,12620,13783,26403,NYANZA
1220,SOUTH EAST NYAKACH,244,NYAKACH,42,KISUMU,14819,15708,30527,NYANZA
1221,WEST KASIPUL,245,KASIPUL,43,HOMA BAY,12159,13648,25807,NYANZA
1222,SOUTH KASIPUL,245,KASIPUL,43,HOMA BAY,12203,13488,25691,NYANZA
1223,CENTRAL KASIPUL,245,KASIPUL,43,HOMA BAY,12328,13688,26016,NYANZA
1224,EAST KAMAGAK,245,KASIPUL,43,HOMA BAY,6987,7601,14588,NYANZA
1225,WEST KAMAGAK,245,KASIPUL,43,HOMA BAY,9828,11187,21015,NYANZA
1226,KABONDO EAST,246,KABONDO KASIPUL,43,HOMA BAY,15318,16644,31962,NYANZA
1227,KABONDO WEST,246,KABONDO KASIPUL,43,HOMA BAY,14926,16205,31131,NYANZA
1228,KOKWANYO/KAKELO,246,KABONDO KASIPUL,43,HOMA BAY,12527,14005,26532,NYANZA
1229,KOJWACH,246,KABONDO KASIPUL,43,HOMA BAY,8644,9280,17924,NYANZA
1230,WEST KARACHUONYO,247,KARACHUONYO,43,HOMA BAY,12824,13245,26069,NYANZA
1231,NORTH KARACHUONYO,247,KARACHUONYO,43,HOMA BAY,11413,12201,23614,NYANZA
1232,CENTRAL,247,KARACHUONYO,43,HOMA BAY,9795,10680,20475,NYANZA
1233,KANYALUO,247,KARACHUONYO,43,HOMA BAY,8977,9707,18684,NYANZA
1234,KIBIRI,247,KARACHUONYO,43,HOMA BAY,9350,10146,19496,NYANZA
1235,WANG'CHIENG,247,KARACHUONYO,43,HOMA BAY,15788,17548,33336,NYANZA
1236,KENDU BAY TOWN,247,KARACHUONYO,43,HOMA BAY,9899,10472,20371,NYANZA
1237,WEST GEM,248,RANGWE,43,HOMA BAY,9404,10307,19711,NYANZA
1238,EAST GEM,248,RANGWE,43,HOMA BAY,10864,12066,22930,NYANZA
1239,KAGAN,248,RANGWE,43,HOMA BAY,14456,16097,30553,NYANZA
1240,KOCHIA,248,RANGWE,43,HOMA BAY,12519,14035,26554,NYANZA
1241,HOMA BAY CENTRAL,249,HOMA BAY TOWN,43,HOMA BAY,14789,15786,30575,NYANZA
1242,HOMA BAY ARUJO,249,HOMA BAY TOWN,43,HOMA BAY,11574,12736,24310,NYANZA
1243,HOMA BAY WEST,249,HOMA BAY TOWN,43,HOMA BAY,5745,6439,12184,NYANZA
1244,HOMA BAY EAST,249,HOMA BAY TOWN,43,HOMA BAY,13002,14589,27591,NYANZA
1245,KWABWAI,250,NDHIWA,43,HOMA BAY,15017,16579,31596,NYANZA
1246,KANYADOTO,250,NDHIWA,43,HOMA BAY,7818,8513,16331,NYANZA
1247,KANYIKELA,250,NDHIWA,43,HOMA BAY,2999,3284,6283,NYANZA
1248,KABUOCH NORTH,250,NDHIWA,43,HOMA BAY,16767,18503,35270,NYANZA
1249,KABUOCH/PALA,250,NDHIWA,43,HOMA BAY,12507,13825,26332,NYANZA
1250,KANYAMWA KOLOGI,250,NDHIWA,43,HOMA BAY,11177,12265,23442,NYANZA
1251,KANYAMWA KOSEWE,250,NDHIWA,43,HOMA BAY,15666,17292,32958,NYANZA
1252,MFANGANO ISLAND,251,SUBA NORTH,43,HOMA BAY,13509,12611,26120,NYANZA
1253,RUSINGA ISLAND,251,SUBA NORTH,43,HOMA BAY,11879,12396,24275,NYANZA
1254,KASGUNGA,251,SUBA NORTH,43,HOMA BAY,9570,10083,19653,NYANZA
1255,GEMBE,251,SUBA NORTH,43,HOMA BAY,9110,9936,19046,NYANZA
1256,LAMBWE,251,SUBA NORTH,43,HOMA BAY,10874,11441,22315,NYANZA
1257,GWASSI SOUTH,252,SUBA SOUTH,43,HOMA BAY,16733,17830,34563,NYANZA
1258,GWASSI NORTH,252,SUBA SOUTH,43,HOMA BAY,15028,15570,30598,NYANZA
1259,KAKSINGIRI WEST,252,SUBA SOUTH,43,HOMA BAY,12684,13337,26021,NYANZA
1260,KAKSINGIRI EAST,252,SUBA SOUTH,43,HOMA BAY,5793,6079,11872,NYANZA
1261,NORTH KAMAGAMBO,253,RONGO,44,MIGORI,8917,9838,18755,NYANZA
1262,CENTRAL KAMAGAMBO,253,RONGO,44,MIGORI,13219,14537,27756,NYANZA
1263,EAST KAMAGAMBO,253,RONGO,44,MIGORI,12931,13926,26857,NYANZA
1264,SOUTH KAMAGAMBO,253,RONGO,44,MIGORI,13173,14006,27179,NYANZA
1265,NORTH SAKWA,254,AWENDO,44,MIGORI,10930,11944,22874,NYANZA
1266,SOUTH SAKWA,254,AWENDO,44,MIGORI,17792,18408,36200,NYANZA
1267,WEST SAKWA,254,AWENDO,44,MIGORI,10504,11774,22278,NYANZA
1268,CENTRAL SAKWA,254,AWENDO,44,MIGORI,13517,14044,27561,NYANZA
1269,GOD JOPE,255,SUNA EAST,44,MIGORI,8872,9695,18567,NYANZA
1270,SUNA CENTRAL,255,SUNA EAST,44,MIGORI,13558,14087,27645,NYANZA
1271,KAKRAO,255,SUNA EAST,44,MIGORI,16068,17574,33642,NYANZA
1272,KWA,255,SUNA EAST,44,MIGORI,8387,8880,17267,NYANZA
1273,WIGA,256,SUNA WEST,44,MIGORI,11530,12566,24096,NYANZA
1274,WASWETA II,256,SUNA WEST,44,MIGORI,8562,9390,17952,NYANZA
1275,RAGANA-ORUBA,256,SUNA WEST,44,MIGORI,15679,17168,32847,NYANZA
1276,WASIMBETE,256,SUNA WEST,44,MIGORI,9219,10013,19232,NYANZA
1277,WEST KANYAMKAGO,257,URIRI,44,MIGORI,12925,13861,26786,NYANZA
1278,NORTH KANYAMKAGO,257,URIRI,44,MIGORI,14713,15683,30396,NYANZA
1279,CENTRAL KANYAMKAGO,257,URIRI,44,MIGORI,8646,9168,17814,NYANZA
1280,SOUTH KANYAMKAGO,257,URIRI,44,MIGORI,13726,13993,27719,NYANZA
1281,EAST KANYAMKAGO,257,URIRI,44,MIGORI,6338,6698,13036,NYANZA
1282,KACHIENG,258,NYATIKE,44,MIGORI,10660,11115,21775,NYANZA
1283,KANYASA,258,NYATIKE,44,MIGORI,6813,7518,14331,NYANZA
1284,NORTH KADEM,258,NYATIKE,44,MIGORI,14572,16125,30697,NYANZA
1285,MACALDER/KANYARUANDA,258,NYATIKE,44,MIGORI,10800,11891,22691,NYANZA
1286,KALER,258,NYATIKE,44,MIGORI,4602,5173,9775,NYANZA
1287,GOT KACHOLA,258,NYATIKE,44,MIGORI,10636,11702,22338,NYANZA
1288,MUHURU,258,NYATIKE,44,MIGORI,11126,11892,23018,NYANZA
1289,BUKIRA EAST,259,KURIA WEST,44,MIGORI,9516,9960,19476,NYANZA
1290,BUKIRA CENTRAL/IKERE,259,KURIA WEST,44,MIGORI,8884,9256,18140,NYANZA
1291,ISIBANIA,259,KURIA WEST,44,MIGORI,11968,11588,23556,NYANZA
1292,MOKERERO,259,KURIA WEST,44,MIGORI,10585,10397,20982,NYANZA
1293,MASABA,259,KURIA WEST,44,MIGORI,10952,11731,22683,NYANZA
1294,TAGARE,259,KURIA WEST,44,MIGORI,10715,11847,22562,NYANZA
1295,NYAMOSENSE'KOMOSOKO,259,KURIA WEST,44,MIGORI,13190,13352,26542,NYANZA
1296,GOKEHARAKA/GETABWEGA,259,KURIA WEST,44,MIGORI,9882,10430,20312,NYANZA
1297,NTIMARU WEST,260,KURIA EAST,44,MIGORI,9949,10490,20439,NYANZA
1298,NTIMARU EAST,260,KURIA EAST,44,MIGORI,5621,6109,11730,NYANZA
1299,NYABASI EAST,260,KURIA EAST,44,MIGORI,10974,11319,22293,NYANZA
1300,NYABASI WEST,260,KURIA EAST,44,MIGORI,13707,13664,27371,NYANZA
1301,BOMARIBA,261,BONCHARI,45,KISII,9676,10942,20618,NYANZA
1302,BOKIAKUMI,261,BONCHARI,45,KISII,13462,14232,27694,NYANZA
1303,BOMORENDA,261,BONCHARI,45,KISII,15148,16804,31952,NYANZA
1304,RIANA,261,BONCHARI,45,KISII,16296,18055,34351,NYANZA
1305,TABAKA,262,SOUTH MIGIRANGO,45,KISII,15446,16669,32115,NYANZA
1306,BOIKANGA,262,SOUTH MUGIRANGO,45,KISII,9488,10378,19866,NYANZA
1307,BOGETENGA,262,SOUTH MUGIRANGO,45,KISII,12540,13599,26139,NYANZA
1308,BORABU/CHITAGO,262,SOUTH MUGIRANGO,45,KISII,18982,20431,39413,NYANZA
1309,MOTICHO,262,SOUTH MUGIRANGO,45,KISII,13085,13526,26611,NYANZA
1310,GETENGA,262,SOUTH MUGIRANGO,45,KISII,7023,7882,14905,NYANZA
1311,BOMBABA BORABU,263,BOMACHOGE BORABU,45,KISII,11425,12299,23724,NYANZA
1312,BOOCHI BORABU,263,BOMACHOGE BORABU,45,KISII,7859,8414,16273,NYANZA
1313,BOKIMONGE,263,BOMACHOGE BORABU,45,KISII,15937,17562,33499,NYANZA
1314,MAGENCHE,263,BOMACHOGE BORABU,45,KISII,16070,17633,33703,NYANZA
1315,MASIGE WEST,264,BOBASI,45,KISII,8768,9724,18492,NYANZA
1316,MASIGE EAST,264,BOBASI,45,KISII,9051,10119,19170,NYANZA
1317,BASSI CENTRAL,264,BOBASI,45,KISII,11142,12204,23346,NYANZA
1318,NYACHEKI,264,BOBASI,45,KISII,14531,16557,31088,NYANZA
1319,BASSI BOGETAORIO,264,BOBASI,45,KISII,15955,18211,34166,NYANZA
1320,BOBASI CHACHE,264,BOBASI,45,KISII,10428,11576,22004,NYANZA
1321,SAMETA/MOKWERERO,264,BOBASI,45,KISII,10404,10842,21246,NYANZA
1322,BOBASI/BOITANGARE,264,BOBASI,45,KISII,9891,10671,20562,NYANZA
1323,MAJOGE BASSI,265,BOMACHOGE CHACHE,45,KISII,11136,12346,23482,NYANZA
1324,BOOCHI/TENDERE,265,BOMACHOGE CHACHE,45,KISII,15935,17262,33197,NYANZA
1325,BOSOTI/SENGERA,265,BOMACHOGE CHACHE,45,KISII,17726,19125,36851,NYANZA
1326,ICHUNI,266,NYARIBARI MASABA,45,KISII,12973,14751,27724,NYANZA
1327,NYAMASIBI,266,NYARIBARI MASABA,45,KISII,10210,11316,21526,NYANZA
1328,MASIMBA,266,NYARIBARI MASABA,45,KISII,12207,13806,26013,NYANZA
1329,GESUSU,266,NYARIBARI MASABA,45,KISII,12253,13568,25821,NYANZA
1330,KIAMOKAMA,266,NYARIBARI MASABA,45,KISII,10010,10976,20986,NYANZA
1331,BOBARACHO,267,NYARIBARI CHACHE,45,KISII,14291,15047,29338,NYANZA
1332,KISII CENTRAL,267,NYARIBARI CHACHE,45,KISII,15827,16376,32203,NYANZA
1333,KEUMBU,267,NYARIBARI CHACHE,45,KISII,7213,7811,15024,NYANZA
1334,KIOGORO,267,NYARIBARI CHACHE,45,KISII,6221,6881,13102,NYANZA
1335,BIRONGO,267,NYARIBARI CHACHE,45,KISII,9103,10265,19368,NYANZA
1336,IBENO,267,NYARIBARI CHACHE,45,KISII,9909,10801,20710,NYANZA
1337,MONYERERO,268,KITUTU CHACHE NORTH,45,KISII,12992,14619,27611,NYANZA
1338,SENSI,268,KITUTU CHACHE NORTH,45,KISII,12789,14750,27539,NYANZA
1339,MARANI,268,KITUTU CHACHE NORTH,45,KISII,13238,14923,28161,NYANZA
1340,KEGOGI,268,KITUTU CHACHE NORTH,45,KISII,9630,10928,20558,NYANZA
1341,BOGUSERO,269,KITUTU CHACHE SOUTH,45,KISII,11699,13173,24872,NYANZA
1342,BOGEKA,269,KITUTU CHACHE SOUTH,45,KISII,6333,6921,13254,NYANZA
1343,NYAKOE,269,KITUTU CHACHE SOUTH,45,KISII,10883,12213,23096,NYANZA
1344,KITUTU CENTRAL,269,KITUTU CHACHE SOUTH,45,KISII,25566,24797,50363,NYANZA
1345,NYATIEKO,269,KITUTU CHACHE SOUTH,45,KISII,9700,10846,20546,NYANZA
1346,RIGOMA,270,KITUTU MASABA,46,NYAMIRA,20636,22664,43300,NYANZA
1347,GACHUBA,270,KITUTU MASABA,46,NYAMIRA,15046,17259,32305,NYANZA
1348,KEMERA,270,KITUTU MASABA,46,NYAMIRA,16808,18499,35307,NYANZA
1349,MAGOMBO,270,KITUTU MASABA,46,NYAMIRA,10500,11763,22263,NYANZA
1350,MANGA,270,KITUTU MASABA,46,NYAMIRA,14370,15919,30289,NYANZA
1351,GESIMA,270,KITUTU MASABA,46,NYAMIRA,16800,18872,35672,NYANZA
1352,NYAMAIYA,271,WEST MUGIRANGO,46,NYAMIRA,15353,17323,32676,NYANZA
1353,BOGICHORA,271,WEST MUGIRANGO,46,NYAMIRA,19718,22108,41826,NYANZA
1354,BOSAMARO,271,WEST MUGIRANGO,46,NYAMIRA,18839,20919,39758,NYANZA
1355,BONYAMATUTA,271,WEST MUGIRANGO,46,NYAMIRA,12578,13258,25836,NYANZA
1356,TOWNSHIP,271,WEST MUGIRANGO,46,NYAMIRA,9531,10046,19577,NYANZA
1357,ITIBO,272,NORTH MUGIRANGO,46,NYAMIRA,13291,14307,27598,NYANZA
1358,BOMWAGAMO,272,NORTH MUGIRANGO,46,NYAMIRA,8147,9105,17252,NYANZA
1359,BOKEIRA,272,NORTH MUGIRANGO,46,NYAMIRA,15624,16858,32482,NYANZA
1360,MAGWAGWA,272,NORTH MUGIRANGO,46,NYAMIRA,8863,9499,18362,NYANZA
1361,EKERENYO,272,NORTH MUGIRANGO,46,NYAMIRA,12860,13799,26659,NYANZA
1362,MEKENENE,273,BORABU,46,NYAMIRA,9837,9139,18976,NYANZA
1363,KIABONYORU,273,BORABU,46,NYAMIRA,21002,22662,43664,NYANZA
1364,NYANSIONGO,273,BORABU,46,NYAMIRA,13738,13757,27495,NYANZA
1365,ESISE,273,BORABU,46,NYAMIRA,13504,13451,26955,NYANZA
1366,KITISURU,274,WESTLANDS,47,NAIROBI,16627,14615,31242,NAIROBI
1367,PARKLANDS/HIGHRIDGE,274,WESTLANDS,47,NAIROBI,19604,18780,38384,NAIROBI
1368,KARURA,274,WESTLANDS,47,NAIROBI,14077,12376,26453,NAIROBI
1369,KANGEMI,274,WESTLANDS,47,NAIROBI,23141,21423,44564,NAIROBI
1370,MOUTAIN VIEW,274,WESTLANDS,47,NAIROBI,18604,17531,36135,NAIROBI
1371,KILIMANI,275,DAGORETI NORTH,47,NAIROBI,20489,22633,43122,NAIROBI
1372,KAWANGWARE,275,DAGORETI NORTH,47,NAIROBI,14526,12875,27401,NAIROBI
1373,GATINA,275,DAGORETI NORTH,47,NAIROBI,24745,21127,45872,NAIROBI
1374,KILELESHWA,275,DAGORETI NORTH,47,NAIROBI,12206,14996,27202,NAIROBI
1375,KABIRO,275,DAGORETI NORTH,47,NAIROBI,20158,19855,40013,NAIROBI
1376,MUTUINI,276,DAGORETI SOUTH,47,NAIROBI,9014,8959,17973,NAIROBI
1377,NGANDO,276,DAGORETI SOUTH,47,NAIROBI,17615,16399,34014,NAIROBI
1378,RIRUTA,276,DAGORETI SOUTH,47,NAIROBI,32370,32950,65320,NAIROBI
1379,UTHIRU-RUTHIMITU,276,DAGORETI SOUTH,47,NAIROBI,15928,16647,32575,NAIROBI
1380,WAITHAKA,276,DAGORETI SOUTH,47,NAIROBI,15323,15731,31054,NAIROBI
1381,KAREN,277,LANGA'TA,47,NAIROBI,18316,14987,33303,NAIROBI
1382,NAIROBI WEST,277,LANGA'TA,47,NAIROBI,15812,17565,33377,NAIROBI
1383,MUGUMOINI,277,LANGA'TA,47,NAIROBI,22319,24718,47037,NAIROBI
1384,SOUTH 'C',277,LANGA'TA,47,NAIROBI,24028,23174,47202,NAIROBI
1385,NYAYO HIGHRISE,277,LANGA'TA,47,NAIROBI,12859,11332,24191,NAIROBI
1386,LAINI SABA,278,KIBERA,47,NAIROBI,15688,12494,28182,NAIROBI
1387,LINDI,278,KIBERA,47,NAIROBI,29743,22778,52521,NAIROBI
1388,MAKINA,278,KIBERA,47,NAIROBI,18260,16768,35028,NAIROBI
1389,WOODLEY/KENYATTA GOL,278,KIBERA,47,NAIROBI,16715,18640,35355,NAIROBI
1390,SERANGOMBE,278,KIBERA,47,NAIROBI,28807,25540,54347,NAIROBI
1391,GITHURAI,279,ROYSAMBU,47,NAIROBI,22679,24509,47188,NAIROBI
1392,KAHAWA WEST,279,ROYSAMBU,47,NAIROBI,22100,17894,39994,NAIROBI
1393,ZIMMERMAN,279,ROYSAMBU,47,NAIROBI,18382,20530,38912,NAIROBI
1394,ROYSAMBU,279,ROYSAMBU,47,NAIROBI,20635,19696,40331,NAIROBI
1395,KAHAWA,279,ROYSAMBU,47,NAIROBI,12066,13199,25265,NAIROBI
1396,CLAY CITY,280,KASARANI,47,NAIROBI,18999,20964,39963,NAIROBI
1397,MWIKI,280,KASARANI,47,NAIROBI,19450,19706,39156,NAIROBI
1398,KASARANI,280,KASARANI,47,NAIROBI,9639,11714,21353,NAIROBI
1399,NJIRU,280,KASARANI,47,NAIROBI,17677,16846,34523,NAIROBI
1400,RUAI,280,KASARANI,47,NAIROBI,18186,17775,35961,NAIROBI
1401,BABADOGO,281,RUARAKA,47,NAIROBI,21065,18971,40036,NAIROBI
1402,UTALII,281,RUARAKA,47,NAIROBI,19878,16397,36275,NAIROBI
1403,MATHARE NORTH,281,RUARAKA,47,NAIROBI,29597,25561,55158,NAIROBI
1404,LUCKY SUMMER,281,RUARAKA,47,NAIROBI,10330,10375,20705,NAIROBI
1405,KOROGOCHO,281,RUARAKA,47,NAIROBI,21958,19988,41946,NAIROBI
1406,IMARA DAIMA,282,EMBAKASI SOUTH,47,NAIROBI,39465,31176,70641,NAIROBI
1407,KWA NJENGA,282,EMBAKASI SOUTH,47,NAIROBI,13009,11350,24359,NAIROBI
1408,KWA REUBEN,282,EMBAKASI SOUTH,47,NAIROBI,15116,10899,26015,NAIROBI
1409,PIPELINE,282,EMBAKASI SOUTH,47,NAIROBI,29772,26426,56198,NAIROBI
1410,KWARE,282,EMBAKASI SOUTH,47,NAIROBI,13720,10109,23829,NAIROBI
1411,KARIOBANGI NORTH,283,EMBAKASI NORTH,47,NAIROBI,19901,19441,39342,NAIROBI
1412,DANDORA AREA I,283,EMBAKASI NORTH,47,NAIROBI,11436,11366,22802,NAIROBI
1413,DANDORA AREA II,283,EMBAKASI NORTH,47,NAIROBI,16927,16748,33675,NAIROBI
1414,DANDORA AREA III,283,EMBAKASI NORTH,47,NAIROBI,19911,20091,40002,NAIROBI
1415,DANDORA AREA IV,283,EMBAKASI NORTH,47,NAIROBI,23179,22388,45567,NAIROBI
1416,KAYOLE NORTH,284,EMBAKASI CENTRAL,47,NAIROBI,19269,20023,39292,NAIROBI
1417,KAYOLE CENTRAL,284,EMBAKASI CENTRAL,47,NAIROBI,24889,25823,50712,NAIROBI
1418,KAYOLE SOUTH,284,EMBAKASI CENTRAL,47,NAIROBI,25507,24810,50317,NAIROBI
1419,KOMAROCK,284,EMBAKASI CENTRAL,47,NAIROBI,16195,19433,35628,NAIROBI
1420,MATOPENI/SPRING VALL,284,EMBAKASI CENTRAL,47,NAIROBI,7700,7230,14930,NAIROBI
1421,UPPER SAVANNA,285,EMBAKASI EAST,47,NAIROBI,24341,20796,45137,NAIROBI
1422,LOWER SAVANNA,285,EMBAKASI EAST,47,NAIROBI,13723,17028,30751,NAIROBI
1423,EMBAKASI,285,EMBAKASI EAST,47,NAIROBI,17192,16892,34084,NAIROBI
1424,UTAWALA,285,EMBAKASI EAST,47,NAIROBI,15482,15468,30950,NAIROBI
1425,MIHANG'O,285,EMBAKASI EAST,47,NAIROBI,12680,10256,22936,NAIROBI
1426,UMOJA I,286,EMBAKASI WEST,47,NAIROBI,21574,26237,47811,NAIROBI
1427,UMOJA II,286,EMBAKASI WEST,47,NAIROBI,24149,29517,53666,NAIROBI
1428,MOWLEM,286,EMBAKASI WEST,47,NAIROBI,11632,11321,22953,NAIROBI
1429,KARIOBANGI SOUTH,286,EMBAKASI WEST,47,NAIROBI,15362,17674,33036,NAIROBI
1430,MARINGO/HAMZA,287,MAKADARA,47,NAIROBI,25965,26328,52293,NAIROBI
1431,VIWANDANI,287,MAKADARA,47,NAIROBI,25823,19058,44881,NAIROBI
1432,HARAMBEE,287,MAKADARA,47,NAIROBI,24952,30504,55456,NAIROBI
1433,MAKONGENI,287,MAKADARA,47,NAIROBI,16322,14700,31022,NAIROBI
1434,PUMWANI,288,KAMUKUNJI,47,NAIROBI,20797,16805,37602,NAIROBI
1435,EASTLEIGH NORTH,288,KAMUKUNJI,47,NAIROBI,23039,20219,43258,NAIROBI
1436,EASTLEIGH SOUTH,288,KAMUKUNJI,47,NAIROBI,34710,31554,66264,NAIROBI
1437,AIR BASE,288,KAMUKUNJI,47,NAIROBI,23256,19912,43168,NAIROBI
1438,CALIFORNIA,288,KAMUKUNJI,47,NAIROBI,11064,10635,21699,NAIROBI
1439,NAIROBI CENTRAL,289,STAREHE,47,NAIROBI,7542,5786,13328,NAIROBI
1440,NGARA,289,STAREHE,47,NAIROBI,12326,13028,25354,NAIROBI
1441,PANGANI,289,STAREHE,47,NAIROBI,17701,19361,37062,NAIROBI
1442,ZIWANI/KARIOKOR,289,STAREHE,47,NAIROBI,5366,5122,10488,NAIROBI
1443,LAND MAWE,289,STAREHE,47,NAIROBI,15434,11075,26509,NAIROBI
1444,NAIROBI SOUTH,289,STAREHE,47,NAIROBI,27278,26025,53303,NAIROBI
1445,HOSPITAL,290,MATHARE,47,NAIROBI,11205,9258,20463,NAIROBI
1446,MABATINI,290,MATHARE,47,NAIROBI,15286,12974,28260,NAIROBI
1447,HURUMA,290,MATHARE,47,NAIROBI,19683,18289,37972,NAIROBI
1448,NGEI,290,MATHARE,47,NAIROBI,18050,16473,34523,NAIROBI
1449,MLANGO KUBWA,290,MATHARE,47,NAIROBI,20621,17753,38374,NAIROBI
1450,KIAMAIKO,290,MATHARE,47,NAIROBI,17053,16771,33824,NAIROBI
